キャッシュメモリ|CPUと主記憶装置との間に置いて、データを高速転送するために一時的に用いる記憶装置。
ディスクキャッシュ|ハードディスクなど低速な記憶装置からデータを読み込むとき、データを一時的にメモリに格納しておくことにより処理を高速化するしくみ。
プラグアンドプレイ|コンピュータに新しいハードウェアを追記するときなど、必要な設定をユーザが手動で設定作業をしなくても、OSが自動的に最適な設定を行うシステム。
SSD|HDD(ハードディスクドライブ)に比べて、軽量小型で読み書き速度も速い、半導体メモリを使用した記憶装置。
ウォーターフォールモデル|比較的大規模な開発に向いており、基本設計、外部設計などいくつかの工程に分割してシステムを開発する手法。原則として前の工程には戻らない。
プロトタイピングモデル|試作品に対するユーザの評価をもとに、システムを開発する手法。
スパイラルモデル|システムを独立性の高い部分ごとに分割し、ユーザの要求やインタフェースの検討などを経て、設計･プログラミング･テストの工程を繰り返してシステムを開発する手法。
基本設計|ユーザと開発者が十分話し合い、ユーザからの要件をシステムに反映できるかを判断して、システムへの要求機能を決定する開発工程。
外部設計|システム開発において、画面や帳票などを利用者側の視点から設計するシステム開発工程。
内部設計|ソフトウェアのアルゴリズムや入出力データなどを詳細に設計するシステム開発工程。
プログラム設計|内部設計に基づいて、各プログラムの内部構造を設計する開発工程。
プログラミング|プログラム設計の結果を受けて、プログラム言語を用いて実際にプログラムを作成(コーディング)する開発工程。
テスト|開発者だけでなくユーザも参加して、完成されたプログラムの検証を行うこと。
単体テスト|個々のプログラム(部品）が、仕様書の要求どおりに機能しているかを確認するテスト。
結合テスト|複数のモジュール(部品)を組み合わせて、モジュール間でデータの受け渡しが設計どおりに行われているかなどを確認するテスト。
システムテスト|開発したシステム全体が、設計どおりの機能を備えているかを確認するテスト。
保守・管理|開発したシステムで、実際の業務中で生じた問題点を修正する作業、システムを効率的に稼働させるための業務。
ブラックボックステスト|プログラムが仕様を満たしているかを確認するために、プログラムの内部構造には着目しないで、データ入力に対する出力結果に注目するテスト。
ホワイトボックステスト|プログラムの内部構造や処理の流れに着目し、プログラムが設計通りに動いているかを確認するテスト。
RASIS|コンピュータシステムに関する評価指標で、信頼性、可用性、保守性、完全性(保全性)、安全性(機密性)の５項目の英文字の頭文字を組み合わせた用語。
信頼性|システムの故障発生が少ないこと。
可用性|一定期間にシステムが正常に使える時間の割合が長いこと。
保守性|故障の際の修復時間が短いこと。
完全性(保全性)|データの矛盾が起きないように、その整合性を維持すること。
安全性(機密性)|不正に情報を持ち出したりすることから守ること。
稼働率|コンピュータシステムが、一定時間内で正常に動作している時間の割合(確率)。
平均故障間隔(MTBF)|コンピュータシステムが故障してから復旧し、次に故障するまでの平均時間。
平均修復時間(MTTR)|コンピュータシステムが故障してから、完全に復旧するまでの平均時間。
スループット|コンピュータシステムや通信回線などが、一定の時間内に処理できる仕事量や伝送できる情報量。
レスポンスタイム|コンピュータシステムに処理を要求してから、最初の応答が得られるまでの時間。
ターンアラウンドタイム|コンピュータに処理実行の指示をしてから、すべての実行結果が得られるまでの時間。
フォールトトレラント|障害が発生しても、システム全体が機能を停止することなく稼働し続けられるようにするしくみ。
フォールトアボイダンス|信頼性の高い部品の採用や利用者の教育など、コンピュータシステムに可能な限り故障や障害が起きないようにすること。
フェールセーフ|障害が発生しても、被害や障害を最小限に止め、安全性を保つしくみ。
フールプルーフ|誤った操作を行っても重大な事故を招かないよう設計すること。
フェールソフト|4台のプリンタのうち1台が故障しても残りの3台で印刷するなど、障害が発生した際に正常な部分だけを動作させ、全体に支障をきたさないようにするしくみ。
クロック周波数|CPUやメモリの動作の基準となる信号を1秒間に発生させる回数で、Hz(ヘルツ)で表す。
MIPS|コンピュータの処理速度を測るために、1秒間に実行できる命令を100万回単位で表したもの。
UPS|停電などのトラブル発生時にコンピュータを安全に停止させるため、電力を一定時間供給する装置。
RAID|信頼性や処理速度を向上させるために、複数のハードディスク装置を並列に組み合わせて一体化し、全体を1つのディスク装置のように扱う方式。
ミラーリング|RAID1に相当し、複数のHDDに同じデータを書き込む方式。1台のハードディスクに障害が起きた場合でも、システムの稼働が可能となるため、信頼性が向上する。なお、処理速度は向しない。
ストライピング|RAID0に相当し複数のHDDに分散して書き込む方式。各HDDに対して、並列にアクセスを実行することで、処理速度が向上する。なお、信頼性は向上しない。
OSI参照モデル|国際標準化機構(ISO)で制定された、ネットワークで使用する機器や、データを送受信する手順など7つの階層に定義したもの。
ハブ|LANケーブルの中継や分岐に用いられる集線装置。
ルータ|ネットワーク間の接続を行う中継機器の一つで、IPアドレスをもとにデータの行き先を認識して転送し、パケットの経路選択機能などを持つ装置。
パケットフィルタリング|ルータが持つ機能の一つで、パケットの通過可否を判断する機能のこと。
ゲートウェイ|プロトコルが異なるネットワーク間において、プロトコルを変換することでデータの送受信を可能にするための装置。
プロトコル|ネットワークを通して、コンピュータどうしが通信を行うために決められた手順で、通信規約ともいう。
TCP/IP|インターネットやイントラネットで標準的に使用され、OSなどの環境が異なるコンピュータ間でも通信を可能にする通信規約。
HTTP|WebサーバとWebブラウザとの間で、HTML文書や関連した画像などのデータを送受信するための通信規約。
FTP|HTMLファイルをWebサーバへアップロードするときなど、ネットワークを介してファイルを転送するための通信規約。
POP|メールサーバのメールボックスに保存されたメールを、受信するために用いる通信規約。
IMAP|メールサーバの電子メールを管理する通信規約。
SMTP|電子メールをユーザのコンピュータからメールサーバへ送信するときや、メールサーバ間でメールを転送するときに用いる通信規約。
DHCP|コンピュータをネットワークに接続する際に、IPアドレスなどを自動的に割り当てる通信規約。
MACアドレス|ルータなどのネットワーク機器に割り当てられているハードウェア固有の番号。
IPアドレス|TCP/IPプロトコルを用いたネットワーク上で、コンピュータを識別するための番号。
プライベートIPアドレス|会社や家庭のLAN内部でコンピュータ機器を識別するために、ネットワークアドレス部とホストアドレス部で構成された番号。
グローバルIPアドレス|インターネットに接続されたコンピュータを識別するため、一意となるように割り当てられた番号。
サブネットマスク|IPアドレスから、特定のグループを示すネットワークアドレスを取り出すための値。
ネットワークアドレス|IPアドレスを構成する32ビットのビット列のうち、個々の組織が管理するネットワーク(サブネット)を識別するのに使われる部分。
ホストアドレス|同一のネットワークグループ内で接続された個々のコンピュータ機器を識別するためのアドレス。
ポート番号|TCP/IPプロトコルを用いたネットワーク上で、IPアドレスに設けられている補助アドレスであり、アプリケーションの識別をするための番号。
NAT|インターネットのグローバルIPアドレスとプライベートIPアドレスを1対1で結び付けて相互に変換し、LAN内のコンピュータがインターネットを利用できるようにするためのアドレス変換の技術。
DMZ|"非武装地帯"と呼ばれ、インターネットなどの外部ネットワークと内部ネットワークから隔離された区域(セグメント)のこと。
DNSサーバ|インターネット上で使用するメイン名とIPアドレスを互いに変換するためのサーバ。
POPサーバ|メールサーバのメールボックスから電子メールを受信するためのサーバ。
SMTPサーバ|インターネットにおいて、電子メールを宛先のメールボックスに転送するためのサーバ。
DHCPサーバ|LAN内のコンピュータをネットワークに接続するときに、使用していないIPアドレスを自動的に割り当てるサーバ。
プロキシサーバ|LAN内部のクライアントの代理としてインターネット接続を行うサーバ。
通信速度(bps)|ネットワーク上でデータを送受信するときに、1秒間に転送できるデータのビット数。
転送時間|データをインターネット上のサーバなどから送信・転送するときの所要時間。
伝送効率|データ通信において、実質的にデータを送ることができる回線の割合。
シンクライアント|クライアントサーバシステムで、クライアントには必要最小限の機能だけを持たせ、サーバでアプリケーションなどの管理を行うシステム構成で、情報漏えい対策としても注目されている。
NAS|TCP/IPのコンピュータネットワークに直接接続して使用するHDD(ハードディスクドライブ)のこと。
Cookie|Webサイトの訪問日時や回数などの情報を、利用者のコンピュータに保存するしくみ。
MIME|各国の言葉や画像、動画など、形式の異なるさまざまなデータを電子メールで扱うための規格。
VoIP|インターネットやイントラネットなどの情報通信ネットワークを使って、音声データを送受信する技術。
共通鍵暗号方式|インターネットでデータを送受信する際に、第三者に内容が知られないようにデータを変換する場合、同一の鍵を用いて暗号化と復号を行う方法。
公開鍵暗号方式|インターネットでデータを送受信する際に、第三者に内容が知られないようにデータを変換する場合、異なる鍵を用いて暗号化と復号を行う方法。
電子署名(ディジタル署名)|公開鍵暗号方式を応用して、文書の作成者が本人であることと、その文書が改ざんされていないことを確認する技術。電子商取引でよく利用される。
認証局(CA)|電子商取引で利用される暗号化通信などで必要となる、ディジタル証明書を発行する機関。
SSL|オンラインショッピングなど、インターネット上で個人情報などのデータを暗号化して、安全にやり取りするために広く普及している技術。ブラウザのURLを示す部分は｢https://｣で始まる。
HTTPS|HTTPに、SSLによるデータ暗号化機能を付加した通信規約。
ログファイル|コンピュータの利用状況やデータ通信の状況を記録したファイル。
システムログ|OSやアプリケーションソフトなど、コンピュータシステムの動作状態を記録したもの。何らかのトラブルなどの情報も記録される。
アクセスログ|Webサーバにアクセスした人物が、いつ、どのコンピュータからどのサイトを閲覧したかなどを記録したもの。
ブレーンストレーミング|4つの原則を守りながら、新しいアイディアを引き出すことを目的に行われる話し合いの技法。
KJ法|問題点を明確にするために、情報収集→カード･グループ化→図解化→文章化の手順で行われるデータの整理方法。
決定表(デシジョンテーブル)|問題を解決するために、複数の条件とその条件に対応する行動を表形式に示した図。
DFD|4つの記号(1組の平行線、矢印、円、四角形)を用いて、データの流れと処理の関係を表す図。
パート図(PERT）|アローダイアグラムともいい、プロジェクトの日程計画や日程管理に用いられ、相互関係にある作業を矢印でつないだ図。
クリティカルパス|パート図(PERT)において、作業の開始から終了までの所要日数が最長となる経路。この経路の一部に遅れが生じると、作業全体のスケジュールに影響する。
ABC分析|パレート図を使用して、各項目を重要な順に3つのグループに分けて、在庫管理などで分析する方法。
パレート図|ABC分析のときに用いられるこどが多いグラフで、データを降順に並べた棒グラフと、その累計比率を表す折れ線グラフからなるグラフ。
Zグラフ|移動合計値(過去1年間分の売上累計)という特徴があるデータを用いて、一定期間の売上高の傾向を分析するときに用いるグラフ。
回帰分析|相関関係にある2つのデータ間の関係や傾向を分析して、結果を予測すること。
散布図|2つの項目の間の相関関係の有無などを示す図表。
正の相関|2つの項目の間で、1つが増加すると、もう1つも増加する関係で、散布図においては、点のばらつき具合が右上がりの状態。
負の相関|2つの項目の間で、1つが増加すると、もう1つが減少する関係で、散布図においては、点のばらつき具合が右下がりの状態。
回帰直線(近似曲線）|散布図において、ばらつきのあるデータの関係を導くために、誤差が最小になる直線。
線形計画法|費用を最小限に抑えて最大の利益を得るための生産計画など、複数の制約条件の中で、最大(最小)値を求める手法のこと。
ヒストグラム|データ範囲をいくつかの区間に分け、各区間に入るデータの数を柱状で表したグラフ。
管理図|中央線と上下一対の限界線を引いて、製品などの特性値をプロットし、品質不良や製造工程の異常を検出して不良原因の除去や再発防止に役立てる。
特性要因図|結果とそれに影響を及ぼしたと思われる原因の関係を体系的に表した図。直接的な原因と間接的な原因に分別して、真の問題点を明確にする効果がある。
ファンチャート|ある時点のデータを基準に、その後のデータの変動を比率で表す折れ線グラフのこと。
SWOT分析|自社の現状を、強み･弱み･機会･脅威の4つの要素に整理して、市場環境を分析すること。
PPM分析|事業管理手法の一つで、自社の製品またはサービスを、市場の成長率と市場の占有率から、金のなる木･花形･問題児･負け犬の4つの区分に分類して、事業展開を決定するための手法。
コンプライアンス|｢法令遵守｣といわれるが、企業が法律や条例を守るだけではなく、企業倫理や社会貢献などを含めて自発的に取り組んでいくこと。
セキュリティーポリシー|企業や団体などの組織における情報セキュリティに関する基本的な方針であり、アクセス権限や保護対象範囲の設定などを具体的にまとめたもの。
ERP(経営資源計画)|企業の持つ人材、資金、設備、情報など様々な経営資源を一元的に管理、有効活用し、業務の効率化を図るための経営全体の最適化を目指す手法。
CRM(顧客関係管理)|企業のすべての部門と顧客との間に信頼関係を築いて、企業と顧客の利益を共に向上することを目指す経営手法。
BPR(業務プロセス再設計)|企業活動に関する売り上げなどの目標を設定して、目標達成のための業務内容、流れ、組織を分析し、最適化や再構築すること。
アウトソーシング|コスト削減などのために自社の業務や機能の一部または全部を、それを専門とする外部の専門業者に委託すること。
アライアンス|複数の企業が互いに経済的なメリットを期待するために、企業が連携して協力体制を構築すること。
ハウジングサービス|顧客のサーバ自体を、ネットワーク環境の整った場所に設置するサービス。
ホスティングサービス|情報通信ネットワークを利用して、自社のサーバを貸し出すサービス。
排他制御|データベースにおいて、あるデータを処理しているとき、他からの更新や書き込みなどを制限することによって、データの整合性を保つしくみ。
ロック|同じデータに、複数のアクセスをする場合の整合性を取るための工夫。
共有ロック|データベースにおいて、ファイルを保持するために、ファイルを読み込むことは可能だが、レコードのデータの変更はできないこと。
占有ロック|一つのレコードに対して一つの参照･変更･削除だけが取得できる。データを更新している途中で、他がデータを読み込んだり、変更できないようになる。
デッドロック|排他制御を行った複数の処理が互いにロックをかけることで、相手のロック解除待ち状態が発生してしまい先に進まなくなる状態。
トランザクション|データベースにおいて、一連の更新処理のこと。
コミット|データベースにおいて、更新処理などがすべて正常に完結したという宣言。
ジャーナルファイル|データベースの更新前と更新後のデータの状態を記録したファイル。
チェックポイント|メモリ上のデータをディスクに書き込むタイミングのこと。障害発生の際、復旧作業に利用されることもある。
ロールバック|データベースにおける更新処理の途中などで、何らかの理由で不都合があった場合、データの整合性を保つために、ジャーナルファイルを用いてトランザクション処理開始時点の状態に戻すこと。
ロールフォワード|データが保存されているハードディスクに障害が発生した場合、バックアップファイルとジャーナルファイルを用いて、ハードディスクの障害発生直前の状態に復元すること。
概念設計|データベース設計の初期段階で、業務内容を分析して必要なデータや管理方法を検討する作業。
論理設計|概念設計の結果をシステム化の対象範囲に限定して定義すること。実際の業務での画面や帳票を参考にして、システムで必要とするデータを洗い出す。
物理設計|論理設計の結果を用いて、処理内容などの観点から、ハードウェアの選択や、最適配置などの検討を行うこと。主キーやインデックスの設定、必要容量の算定も行う。
非正規形|データの矛盾や重複(冗長性)があり、DBMSへの負担がかかる表の構造。
第1正規化(正規形)|非正規形から、重複して繰り返し現れる項目を排除すること。
第2正規化(正規形)|第1正規形から、主キーと関連のある項目を別のテーブルに分割すること。
第3正規化(正規形)|第2正規形から、主キーでない項目について、関連のある項目を別のテーブルに分割すること。
E-R図|データベース設計において、データの関連性をモデル化するために、｢実体｣、｢属性｣、｢関係｣の3つの図形を用いて表す図。
エンティティ|一単位として扱われるデータのまとまりや、データベースとして表現すべき対象物のこと。論理設計の段階では、表に相当する。
アトリビュート|エンティティが持つ特性、特徴などの値。
リレーションシップ|エンティティとエンティティの相互関係。
整合性制約(参照整合性)|レコードの追加や削除が勝手に行われないように、データベースの参照関係の整合性に関する規則。
副問合せ|ある表に対して問い合わせを行い、その結果を利用してさらに、次の問い合わせを行うときの最初の問い合わせ。