win|勝つ
improve|を改善する
develop|を発達させる
increase|を増やす
grow|成長する
create|を創造する
produce|を生産する
provide|供給する
support|支持する
believe|信じる
consider|を(〜だと)見なす
expect|予期する、期待する
choose|選ぶ
decide|決める
suggest|提案する
explain|説明する
offer|提供する
allow|許す
require|必要とする
order|注文する
spend|使う
cost|かかる
pay|支払う
hold|持つ
store|保管する
reach|到着する
seem|思われる
appear|のように見える
happen|起こる
lie|うそをつく、横たわる
stand|立つ、我慢する
return|戻る
control|支配する
lead|導く
unite|結合する
follow|従う
include|含む
continue|続く
last|長持ちする
remain|のままでいる
discover|発見する
tend|傾向がある
concern|関係する、心配させる
brain|脳
mind|心、精神
thought|考え
view|意見
matter|問題
interest|興味
rule|規則
reason|理由
result|結果
cause|原因
effect|影響、効果
form|形
state|状態
research|研究、調査
skill|技術
technology|科学技術
education|教育
language|言語
passage|一節
sound|音
term|期間、学期
author|著者
experience|経験
culture|文化
individual|個人
company|会社
community|地域社会
society|社会
government|政府
population|人口
value|価値
environment|環境
amount|金額
situation|状況
free|自由な
human|人間の
close|ごく近い
enough|十分な
possible|可能な
common|共通の
certain|確信して、必ず
clear|明らかな
major|主要な
particular|特別の
similar|似ている
present|出席している、現在の
recent|最近の
low|低い
local|地元の
patient|我慢強い
serious|真剣な、深刻な
therefore|したがって
thus|したがって
rather|むしろ、かなり
instead|その代わりに
perhaps|もしかすると
unlike|と違って
agree|賛成する
accept|受け入れる
adapt|順応する
avoid|避ける
notice|気づく
wonder|思う
realize|理解する
wish|思う
demand|要求する
claim|主張する
argue|主張する
encourage|励ます
force|無理やりさせる
compare|比べる
imagine|想像する
challenge|異議を唱える
protect|保護する
save|節約する
involve|巻き込む
worry|心配する
affect|影響する
pick|選び取る
relate|関連づける
miss|乗り遅れる、逃す
lack|不足している
exist|存在する
share|共同で使う
fill|満たす
receive|受け取る
raise|上げる
add|加える
reduce|減らす
deal|対処する、扱う
describe|特徴を述べる
enter|入る
design|設計する
complete|終わらせる
depend|依存する
surprise|驚かせる
refer|言及する
fail|損なう
spread|広がる
measure|測る
plant|植物
nature|自然
climate|気候
condition|状況
sentence|文、刑
issue|出版する、問題
subject|科目、主題
source|源
practice|練習
experiment|実験
evidence|証拠
account|説明
influence|影響
benefit|利益
risk|危険性
fear|恐怖
rest|休息
quality|質
figure|図
project|事業
article|記事
professor|教授
effort|努力
knowledge|知識
memory|記憶
role|役割
movement|運動
opportunity|機会
disease|病気
medicine|薬
species|種
death|死
industry|産業
customer|顧客
likely|ありそうな
whole|全体の
native|生まれた土地の
various|さまざまな
general|一般的な
Physical|身体の
available|利用できる
expensive|高価な
political|政治の
safe|安全な
ancient|古代の
due|予定で、締め切りの
appropriate|適切な
correct|正しい
complex|複雑な
blank|空白の
mobile|可動式の
significant|重要な
eventually|ついに
nearly|もう少しで
mostly|たいてい
otherwise|さもないと
indeed|実に
express|表現する
communicate|意思を通じ合う
suppose|思う、もし~ならば
recognize|それとわかる
respect|尊敬する
regard|見なす
mention|言及する
bite|かみつく
prefer|方を好む
determine|決定する
contact|連絡を取る
approach|近づく
apply|申し込む
introduce|紹介する
establish|設立する
attend|出席する
serve|仕える,役立つ
treat|扱う
maintain|維持する
contain|含む
join|参加する
perform|行う
marry|結婚する
survive|生き残る
achieve|達成する
advance|進む
prevent|妨げる
gain|手に入れる
prove|証明する
fit|ぴったり合う
prepare|準備する
supply|供給する
mark|つける
solve|解決する
occur|起こる
object|物、反対する
damage|損害を与える
discuss|議論する
represent|象徴する
attack|襲う、攻撃する
waste|浪費する
bear|我慢する
material|材料、原料
moment|瞬間
crime|犯罪
trouble|苦労
loss|損害、失うこと
factor|要因、要素
resource|資源
cell|細胞
bill|請求書
range|範囲
medium|媒体、手段
generation|世代
purpose|目的
planet|惑星
region|地域
trade|貿易
attitude|態度
function|機能
policy|政策、方針
method|方法、手段
advantage|有利な点
character|性格
task|課題
economy|経済
focus|焦点
temperature|温度,体温
sort|種類
aspect|側面
detail|詳細
reality|現実
decade|10年間
feature|特徴
emotion|感情
charge|突撃する,管理
male|男性の
wild|野生の
urban|都市の
huge|巨大な
private|個人的な
worth|価値のある
essential|必要不可欠な
positive|積極的な
negative|否定的な
chemical|化学の
ordinary|普通の
unique|特有の
specific|特定の
central|中心的な
direct|直接の
current|現在の
official|公式の
mental|精神の
aware|気づいて
necessarily|必ずしも
merely|単に
unfortunately|残念なことに
moreover|その上、さらに
besides|しかも
seek|（～しようと）と努める , を探し求める
search|を（...求めて）検索する
observe|を観察する ， に気づく ， と述べる
survey|を（質問して）調査する
connect|を（...と）つなぐ ， を関連させる
separate|を（...から）分離する
divide|を分割する , 分類する ， を分配する
replace|を（...と）取り替える ， にとって代わる
hide|を隠す ， 隠れる
exchange|（を）交換する
respond|（...に）応答する ， 反応する
publish|を出版する
associate|を連想する ， （...と）付き合う
guess|を推測する ， （...だ）と思う
assume|～と仮定する
reflect|を反映する ， を反射する
indicate|（...ということ）を示す
reveal|を（...に）明らかにする ， 暴露する
doubt|を疑わしいと思う ， （...では）ないと思う
refuse|を拒む
match|調和する、匹敵する
ignore|を無視する
decrease|減る、減らす
decline|減る、衰える、断る
disappear|姿を消す
destroy|破壊する
burn|燃える、燃やす
estimate|推定する、評価する
manage|何とかやり遂げる、経営する
feed|食べ物を与える、を食べる
attract|惹きつける
promote|を促進する、(受身形で)昇格する
attempt|を試みる
contribute|貢献する、寄付する
succeed|成功する、後を継ぐ
desire|を強く望む
earn|を稼ぐ
satisfy|を満足させる
identify|を特定する、を同一のものとみなす
collect|を集める
invite|を招待する、(良くない事態を)引き起こす
taste|の味がする、味を見る
structure|構造
surface|表面、外見
degree|程度、(温度などの)度、学位
site|用地、場所、遺跡
content|内容、目次
profit|収益、利益
income|収入
career|経歴、生涯の職業
electricity|電気
fuel|燃料
household|世帯、家族
convenient|便利、便利なもの、便宜
principle|原理、主義
atmosphere|雰囲気、大気
difficulty|困難、苦労
conflict|争い、衝突
contrast|対称
poverty|貧困
ancester|祖先
birth|出産、誕生
race|民族、人種、競争
origin|起源
tradition|伝統、伝承
imigrate|(外国からの)移民
access|入手、接近
crowd|群衆
crop|作物
carbon|炭素
device|装置
creature|生き物
insect|昆虫
habit|習慣
audience|観衆
interview|面接
responsible|責任がある
financial|財政の
independent|自立した
familiar|よく知っている
normal|普通の
regular|定期的な
comfortable|快適な
obvious|明らかな
active|積極的な
potential|潜在的な
legal|法律上の
entire|全体の
quiet|静かな
terrible|ひどい
tiny|とても小さな
careful|注意深い
vast|膨大な
equal|等しい
fair|公正な
seldom|めったに...ない
somehow|どういうわけか
altogether|全く
lately|最近
furthermore|その上
engage|を従事させる
adopt|を採用する
acquire|取得する
expand|を拡大する
admit|認める
appreciate|をありがたく思う、を正しく認証（評価）する
examine|を調べる
judge|を判断する
remove|を取り去る
combine|を組み合われる
tie|を結びつける
define|を定義する
invent|を発明する
preserve|を保存する
fix|を修理する
stick|くっつく、を張り付ける
strike|に当たる、（考えが）（人）の心に浮かぶ
press|を押す
confuse|を混同させる、を困惑させる
excuse|を大目に見る、を弁解する
recall|思い出す
conduct|行う
behave|振る舞う
trust|信頼する
rely|頼る
count|数える
predict|予測する
aid|援助する
pull|引いて動かす
tear|引き裂く
suit|似合う
steal|盗む
suffer|苦しむ
complain|不平を言う
hurt|痛める
address|演説をする
enable|可能にする
graduate|卒業する
flow|流れる
emarge|現れる
belong|所属している
repeat|繰り返す
pollution|汚染
emission|排出量
progress|進歩
wealth|富
scale|規模
mass|集団
track|跡
trend|傾向
strategy|戦略
aim|目的
basis|基準
fund|資金
stock|株式
literature|文学
scene|場面
traffic|交通量
vehicle|乗り物
cancer|癌
universe|宇宙
authority|当局,権力
institution|機関
colleague|同僚
resident|居住者
volunteer|ボランティア
consequence|結果
capacity|能力
debate|論争
revolution|革命
custom|慣習
threat|恐れ
struggle|懸命の努力
context|状況
gene|遺伝子
phenomenon|現象
alternative|代替の
previous|以前の
former|以前の
relative|相対的な
primary|最も重要な
extreme|極端な
complicated|複雑な
accurate|正確な
false|誤った
intelligent|聡明な
intellectual|知的な
willing|いとわない
polite|丁寧な
formal|正規の
senior|高齢者の
violent|暴力的な
rare|珍しい
purchase|購入する
afford|持つ余裕がある
handle|扱う
demonstrate|証明する
consume|消費する
appeal|心に訴える
display|展示する
release|放出する
locate|置く
organize|組織する
operate|操作する
advertise|宣伝する
select|選び出す
compete|競争する
participate|参加する
conclude|結論づける
mix|混ぜる
perceive|～に気付く
smell|においがする
blow|吹く
hate|大変嫌う
reject|拒絶する
deny|否定する
escape|免れる
blame|せいにする
remind|思い出させる
amaze|驚嘆させる
bore|退屈させる
convince|納得させる
extend|延長する
intend|意図する
insist|要求する
reply|返事を出す
typical|典型的な
rural|田園の
commercial|商業的な
straight|真っ直ぐな
efficient|効率のよい
ideal|理想的な
actual|実際の
explore|探検する
encounter|直面する
settle|定住する
emphasize|強調する
evolve|発展する
cure|治す
freeze|凍る
repair|修理する
recommend|勧める
disaster|災害
flood|洪水
soil|土壌
moral|道徳
religion|宗教
reward|褒美
element|要素
perspective|観点
civilization|文明
democracy|民主主義
foundation|基盤
capital|資本
era|時代
circumstance|状況
comment|見解
campaign|運動
symbol|象徴
conference|会議
court|法廷
trial|裁判
hypothesis|仮説
statistics|統計
analysis|分析
laboratory|研究所
organ|臓器
fossil|化石
agriculture|農業
property|財産
square|正方形
client|依頼人
ability|能力
anxiety|不安
joke|冗談
delay|遅れ
tough|困難な
severe|厳しい
constant|絶え間ない
sensitive|敏感な
nervous|緊張して
narrow|狭い
broad|広範囲な
enormous|巨大な
thick|分厚い
empty|からの
strict|厳しい
firm|確固とした
fundamental|基本の
linguistic|言語の
conscious|意識して
alive|生きている
excellent|すばらしい
calm|冷静な
rapid|急速な
military|軍の
civil|市民の
distant|遠い
contrary|反対の
remarkable|著しい
reserve|を予約する
deliver|配達する
gather|を集める
import|を輸入する
transport|を輸送する
transform|を変える
translate|を翻訳する
interpret|を解釈する
facinate|を魅了する
embarrass|困らせる
disappoint|を失望させる
bother|に迷惑かける
oppose|に反対する
ban|禁止する
frighten|を怖がらせる
regret|を後悔する
overcome|を克服する
commit|約束する、犯す
employ|を雇用する
obtain|を得る
propose|を提案する
announce|を発表する
inspire|を奮起させる
inform|に知らせる
breathe|呼吸する
borrow|を(無料で)借りる
invest|投資する
grant|を(求めに応じて)与える
distinguish|見分ける
differ|異なる
construct|を建設する
manufacture|を(大量に)製造する
arise|生じる
breed|(動物が子を)産む
celebrate|(行事など)を祝う
react|反応する
rush|急いで行く
stare|じっと見つめる
consist|成る
imply|を暗に示す
melt|(熱で)溶ける
warm|に警告する
youth|青年時代
gender|(男女の)性
tribe|部族
army|軍隊
minister|大臣
victim|被害者 犠牲者
harm|害
crisis|危機
hunger|飢え
dozen|1ダース
quarter|4分の1
length|(物や時間の)長さ
notion|考え
criticism|批判
review|批評
confidence|自信
philosophy|哲学
broadcast|放送
occasion|機会
code|規範
dialect|方言
ritual|儀式
substance|物資
virus|ウイルス
barrier|障壁
diversity|多様性
corporation|(大)企業
facility|施設
agency|(行政上の)機関
instrument|楽器
leisure|余暇
vision|(将来の)展望
emergency|緊急(事態)
glacier|氷河
reasonable|理にかなった
sufficient|十分な
smart|頭の良い
pleasant|(物事が)楽しい
elementary|初等(教育)の
proper|適切な
virtual|仮想の
sudden|急な
immediate|即座の
remort|遠く離れた
unclear|原子力の
aggressive|攻撃的な
contemporary|現代の
conventional|従来の
asleep|眠って
minor|重要でない
evil|邪悪な
anxious|心配して
domestic|国内の
widespread|広範囲にわたる
verbal|言葉による
thin|薄い
annual|1年間の
crucial|重大な
adjust|順応する
accustom|を慣れさせる
arrange|を(きちんと)ならべる
absorb|吸収する
abandon|を捨てる
recover|回復する
guarantee|を保証する
confirm|確認する
dominate|を支配する
secure|を確保する
capture|を捕らえる
dig|を掘る
transfer|を移す
alter|を変える
apologize|謝る
advise|に助言する
permit|を許可する
persuade|を説得する
command|を命ずる
praise|をほめる
admire|に感嘆する
award|を授与する
possess|を所有している
pretend|ふりをする
upset|を動揺させる
annoy|を悩ます
scare|を怖がらせる
crash|(大きな音を立てて)衝突する
injure|を傷つける
lift|を持ち上げる
isolate|を孤立させる
shake|を振る
swallow|を飲み込む
lend|(人)に(物)を貸す
expose|をさらす
investigate|を調査する
hire|を雇う
favor|に賛成する
hurry|急ぐ
chat|おしゃべりする
remark|と述べる
concentrate|精神を集中する
ceremony|式典
humanity|人類
proportion|割合
territory|領土
continent|大陸
valley|谷
earthquake|地震
harvest|収穫
grain|穀物
quantity|量
shortage|不足
depression|不景気
fault|過失
alarm|警報(機)
weapon|武器
prison|刑務所
wisdom|賢いこと
instruction|指示
budget|予算(案)
vote|投票
theory|理論
mystery|なぞ 神秘
myth|神話
psychology|心理学
innovation|革新
duty|義務
routine|日課
mammal|哺乳類
infant|乳児
fee|料金
surgery|(外科)手術
trait|(人の性格などの)特性
edge|へり
landscape|風景
biological|生物(学)の
marine|海洋の
tropical|熱帯(地方)の
exact|正確な
pure|純粋な
initial|初期の
principal|主要な
superior|優れている
vital|極めて重要な
intense|激しい
distinct|全く異なる
numerous|多数の
odd|奇妙な
extraordinary|並はずれた
artificial|人工の
manual|手による
rational|理性のある
cuarios|好奇心の強い
lonely|(孤独で)寂しい
rude|無礼な
shy|内気な
equivalent|相当する
precise|正確な
brief|短時間の
illustrate|を説明する
distribute|を配送する
cope|(うまく)対処する
detect|を見つける
convey|を伝達する
stretch|伸びる
calculate|を計算する
pile|を積み重ねる
launch|を始める
export|を輸出する
protest|抗議する
disturb|を邪魔する
surround|を囲む
devote|(時間など)を充てる
occupy|を占める
pursue|を追求する
quit|をやめる
shut|を閉める
collapse|崩壊する
dislike|を嫌う
neglect|をおろそかにする
restrict|を制限する
declare|を制限する
urge|を強く促す
approve|賛成する
hug|を抱き締める
bow|おじぎする
sue|訴える
puzzle|を当惑する
exhaust|を使い果たす
delight|を大喜びさせる
suspect|疑う
attach|をつける
lay|横になる,を置く
fold|を折り畳む
accompany|と一緒に行く
resemble|に似ている
weight|の重さがある
rent|を賃借りする
stimulate|を刺激する
scream|叫び声を上げる
retire|引退する
destination|目的地
discipline|規律 しつけ
district|(行政などの)地区
enemy|敵
opponent|(試合などの)相手
poison|毒
burden|(精神的)負担
garbage|(生)ごみ
stuff|持ち物 材料
height|高度
row|(横の)列
outcome|結果
symptom|症状
incident|事件
wound|傷
sacrifice|犠牲(的行為)
insight|洞察(力)
mission|使命 任務
reputation|評判
profession|(専門的な)職業
muscle|筋肉
welfare|福祉
justice|正義
treasure|宝物
colony|植民(地)
election|選挙
pole|棒,極(地)
witness|目撃者
glance|ちらりと見る
trace|形跡,たどる
secretary|秘書
editor|編集者
sum|総額
liquid|液体
flexible|柔軟な
plain|わかりやすい
modest|控えめな
eager|熱望して
stable|安定した
internal|内部の
external|外部の
solid|固体の
raw|生の
permanent|永久の
temporary|臨時の
instant|即時の
reluctant|気が進まない
stupid|愚かな ばかげた
frank|(人に対して)率直な
alike|似ている
frequent|頻繁な
incredible|信じられない
royal|王室の
primitive|原始の
guilty|罪悪感のある
mutual|相互の
steady|着実な
apparent|明らかな
defend|を守る
beat|(続けざまに)打つ 殴る
defeat|(対戦相手)を負かす
resist|を我慢する
accuse|を非難する
punish|を罰する
evaluate|を評価する
pose|(問題など)を投げかける
impose|を押しつける
compose|を構成する
yield|を産出する
derive|由来する
eliminate|を取り除く
sustain|を持続させる
hang|を掛ける
load|を積む
seal|を密閉する
substitute|を代わりに使う
bend|を曲げる
boil|を沸かす
pour|を注ぐ
cheer|を元気づける
awake|目覚める
dispute|に異議を唱える
endure|を我慢する 耐える
imitate|をまねる 手本とする
impress|を感動させる
ruin|を台無しにする
classify|を分類する
convert|を変える
assist|(人)を手伝う
pause|(一時的に)休止する 間合いを置く
vanish|消え失せる
discourage|に思いとどまらせる を落胆させる
relieve|(苦痛など)を和らげる 減らす
frustrate|に不満を抱かせる
weaken|を衰弱させる 弱める
accomplish|を成し遂げる
deserve|に値する
owe|はおかげである
polish|を磨く
shine|輝く
logic|論理
mechanism|仕組み
frame|額縁
boundary|境界(線)
committee|委員会
council|(地方自治体の)議会
jury|陪審(員団)
neighbor|近所の人 隣人
globe|世界
empire|帝国
horizon|水平線 地平線
furniture|家具
tag|値札
trash|ごみ
litter|(公共の場での)ごみ
wheat|小麦
courage|勇気
passion|情熱
prejudice|偏見
faith|信頼
honor|光栄
luxury|ぜいたく
priority|優先事項
guard|警戒
fate|運命
trap|わな
physician|内科医 医師
slave|奴隷
thief|泥棒
scholarship|奨学金
discount|割引
poety|(集合的に)詩
shade|日陰
throat|のど
slight|わずかな
tight|しっかりした (服・靴などが)きつい
smooth|滑らかな
subtle|微妙な
prime|もっと重要な 第一の
precious|貴重な
urgent|緊急な
ulitimate|最終的な 究極の
genuine|本物の
spare|余分の
gentle|優しい
mature|大人になった
casual|形式ばらない 打ち解けた
fluent|流ちょうな
adequate|十分な
multiple|多くの(部分から成る)
dynamic|(人が)活動的な
ethnic|民族の 人種の
indifferent|無関心な
alien|異質の
acid|酸性の
abstract|抽象的な
sacred|神聖な
ugly|醜い
quote|(を)引用する
arrest|を逮捕する
bury|を埋葬する
interrupt|をさえぎる を中断させる
restore|を(元の状態に)戻す 修復する
wrap|を包む
exhibit|展示する
grip|をしっかり握る
chase|を追いかける
postpone|を延期する
spoil|を台無しにする
cultivate|耕す
forbid|を禁じる
distract|(注意など)をそらす
modify|を(部分的に)修正する
grasp|をぎゅっとつかむ
forgive|(人の罪など)を許す
rescue|を救う
entertain|(人)を楽しませる
consult|(専門家)に意見を求める (辞書など)を調べる
esteem|を尊敬する
greet|(人)に挨拶する
obey|に従う
thrill|を(興奮・快感などで)わくわく［ぞくぞく］させる
deceive|をだます
envy|をうらやむ
justify|を正当化する
resolve|を解決する
forecast|を予測［予想］する
undergo|(変化・試練など)を経験する
float|浮かぶ
leap|飛ぶ
venture|危険を承知で進む
exceed|を上回る
nod|うなずく
hesitate|ためらう 遠慮する
withdraw|を撤回する (預金)をおろす
interfere|邪魔をする 干渉する
gaze|(興味・喜びを持って)見つめる
cough|咳をする
dive|(頭から)飛び込む
burst|破裂する
shame|残念なこと
humor|ユーモア
ambition|願望 夢
debt|借金
usage|(言語の)(慣)用法
occupation|職業
retreat|後退
pardon|許すこと
voyage|航海
legend|伝説
means|手段
pity|哀れみ
affair|事柄 出来事
tragedy|悲惨な出来事
sympathy|同情 共感
fame|名声
instinct|本能
fortune|財産 幸運
merchant|商人
candidate|候補者
oxygen|酸素
geography|地理
span|期間
ecology|生態系
tide|潮(の干満)
architecture|建築(術)
suburb|(都市の)郊外
fare|運賃
baggage|手荷物
nutrition|栄養摂取
refrigerator|冷蔵庫
cabinet|内閣 (飾り)棚
cooperation|協力
divorce|離婚
pale|青白い
rough|ざらざらした
vague|漠然とした
vivid|生き生きとした
antique|骨董の 古風な
passive|受動的な 消極的な
awkward|ぎこちない 気まずい
brave|勇敢な
dull|退屈な
optimistic|楽観的な
pessimistic|悲観的な
liberal|寛大な
sensible|賢明な
selfish|自分勝手な
cruel|残酷な
innocent|無実の 無邪気な
bitter|つらい
thirsty|喉が渇いた
delicate|取り扱いの難しい
jealous|嫉妬深い
ashamed|恥じて
neutral|中立の
desperate|絶望的な 極度の
probable|(十分に)ありそうな
acknowledge|を認める
prohibit|を禁止する
blossom|成長する 開花する
embrace|を抱き締める
confront|(問題などが)に立ちはだかる
heal|を治す 癒やす
rear|を育てる
assign|(物・仕事など)を割り当てる
exaggerate|を誇張する
pronounce|を発音する を明言する 宣言する
reinforce|を強化する
constitute|を構成する
reform|を改革する
violate|(法など)に違反する
irritate|をいらいらさせる
cease|をやめる
insult|を侮辱する
resort|(手段に)訴える
correspond|(・・・に)一致する
conquer|を征服する
prevail|(・・・の間に)普及する
persist|(・・・に)固執する
renew|を更新する
scatter|をまき散らす
conceal|を隠す
flourish|繁栄する
sink|沈む
overwhelm|参らせる
attribute|(・・・の)せいと考える
exclude|を(・・・から)除外する
rob|(人)から奪う
deprive|(人)から(・・・を)奪う
wander|ふらつく 歩き回る
confine|を限定する
reverse|を逆転させる
decorate|を装飾する
anticipate|を予期する
astonish|を(ひどく)驚かせる
spell|(語)をつづる
assess|を評価する
accumlate|をためる 蓄積する
dismiss|を解雇する
discrimination|(・・・に対する)差別
ethusiasm|熱心
obstacle|障害(物)
faculty|(・・・の)才能
abuse|濫用
obligation|(・・・に対する)義務
regulation|規則
credit|信用
contract|(・・・との ・・・のための)契約
insurance|保険
ingredient|(料理の)材料
inhabitant|住民
conservation|(自然環境などの)保護
peer|(能力・年齢などが)同等の人 仲間
scheme|計画
privilege|特典 特権
prosperity|繁栄
heritage|(文化・自然)遺産
orbit|軌道
dimension|側面
portion|部分
infection|伝染病
famine|飢饉
obesity|肥満
appetite|食欲
temper|(怒りっぽい)気質
sweat|汗
core|核心 中心
sequence|連続
proverb|ことわざ
clue|(・・・への)手がかり
procedure|手順
atom|原子
galaxy|銀河
absolute|絶対的な
inevitable|避けられない
radical|根本的な
prompt|迅速な
endangered|絶滅の危機にある
extinct|絶滅した
arctic|北極(地方)の
harsh|厳しい
abundant|豊富な
competent|有能な
prominent|重要な
brilliant|すばらしい
dense|密集した
grand|豪華な
horrible|実にひどい
miserable|惨めな
ridiculous|ばかげた
moderate|適度な
generous|気前のよい
mild|温厚な,温暖な
noble|高貴な
grateful|(・・・に)感謝している
keen|(・・・に)熱心な
deaf|耳が聞こえない
fulfill|(役割・義務など)を果たす
discard|を捨てる
explode|爆発する
exploit|を搾取する
disgust|に嫌悪感を持たせる
equip|に(・・・を)装備させる
inherit|を(・・・から)相続する
transmit|をつたえる
cheat|カンニングをする
dedicate|を(・・・に)ささげる
split|を分裂させる
spill|(液体など)を(・・・に)こぼす
sweep|を掃く を押し流す
strip|を脱ぐ を(・・・から)取り去る
shed|小屋,(涙・血)を流す
submit|を(・・・に)提出する
compromise|(・・・と ・・・について)妥協する
compensate|(人)に(・・・対して)補償する
inquire|(・・・について)尋ねる
offend|を怒らせる
amuse|を笑わせる
strain|をぴんと張る
comprehend|を理解する
appoint|(人)を(・・・に)任命する
attain|を達成する
whisper|(を)(・・・に)ささやく
yell|(を)叫ぶ
boast|(・・・を)自慢する
starve|飢えに苦しむ
bully|をいじめる
crawl|はう
commute|(・・・へ)通勤［通学］する
proceed|進みます
refrain|(〜するのを)控える
fade|(徐々に)消えていく
dare|(否定文・疑問文で)あえて(〜)する
beg|を懇願する
knit|を編む
lean|(・・・に)寄りかかる
bet|(を)賭ける きっと(・・・だ)と思う
digest|(食べ物)を消化する
impulse|(〜したいという)衝動
motive|(・・・の)動機
virtue|美徳
courtesy|礼儀正しさ
acquaintance|知り合い
consent|承諾
ignorance|(・・・を)知らないこと
spectator|(スポーツなどの)観客
narrative|話
output|生産(高)
dignity|尊厳
destiny|(避けられない)運命
funeral|葬式
worship|崇拝
triumph|(大きな)勝利
viewpoint|観点
dawn|夜明け
illusion|錯覚
phase|階段
draft|草稿
toll|(災害などによる)損害
tuition|授業料
circulation|血行
criterion|(判断などの)基準
sculpture|彫刻
grave|墓
tap|蛇口 栓
nursery|保育園
republic|共和国
despair|絶望
decay|虫歯(になった部分)
fatigue|疲労
defect|欠陥
tremendous|(数量などが)とてつもない
loose|解き放された
tense|張り詰めた
steep|(斜面が)急な
shallow|浅い
gradual|徐々の
neat|きちんとした
scarce|乏しい
awful|ひどい
hostile|敵
immense|計り知れない
thorough|徹底的な
valid|正当な
definite|確定した
magnificent|壮大な
holy|神聖な
metropolitan|大都市の
interior|内側の 室内の
bare|裸の
naked|裸の
inferior|(・・・より)劣った
decent|きちんとした
sincere|誠実な
bold|大胆な
scratch|をかく
mend|を修理(修繕)する
dye|を染める
bind|を(・・・で)縛る
bathe|を入浴させる
soak|を(・・・に)浸す
utilize|を利用する
assure|を(・・・だと言って)安心させる
conform|(規則・習慣などに)従う
undertake|を引き受ける
overtake|に追いつく
invade|を侵略する
tease|を(しつこく)からかう
utter|(言葉などを)を発する
confess|(を)告白する
disclose|を明らかにする
betray|を裏切る
contradict|を(間違っていると)否定する
scold|(特に子供)を叱る
condemn|を強く非難する
disregard|を無視する
surrender|を(・・・に)引き渡す
disguise|を変装させる
penetrate|(を)貫く
tolerate|に耐える
suspend|を一時的に中止する
seize|を(ぐいと)つかむ
coincide|(・・・と)同時に起こる
dispose|(despise ofで)を処分する
congratulate|(人)に(・・・のことで)祝いの言葉を述べる
slap|を(平手で)ぴしゃりと打つ
weep|(涙を流して)泣く 涙を流す
resign|(を)辞する
ache|(・・・で)(持続的に)痛む
dread|をひどく恐れる
thrust|(を)ぐいと押す 突く
speculate|推測する
conceive|(を)想像する
pray|祈る
stir|をかき回す
friction|摩擦(力) あつれき
rebel|反逆者
fraction|ほんの少し
quarrel|(・・・との)口論
caution|用心 注意
coward|臆病者
mercy|(・・・に対する)情け 慈悲
glory|栄光(を与えるもの)
sorrow|悲しみ
grief|深い悲しみ
conscience|良心 罪の意識
refuge|(・・・からの)避難
pastime|気晴らし
glimpse|ちらりと見えること
suicide|自殺
prestige|信望 名声
glow|燃えるような輝き
biography|伝記
navy|海軍
ambassador|(しばしばA〜)(・・・駐在の)大使
offspring|(人・動物の)子
crew|乗組員(全員) 乗務員(全員)
diameter|直径
astronomy|天文学
superstition|迷信
encyclopedia|百科事典
rumor|うわさ
microscope|顕微鏡
sphere|球体
plague|疫病
laundry|(the〜)洗濯物
flame|炎
monument|記念碑
deliberate|故意の
supreme|最高の 最大の
splendid|すばらしい
earnest|真剣な
peculiar|(・・・に)特有の
inclined|(〜し)たいと思う (〜する)傾向がある
fierce|どう猛な
absurd|ばかげた
acute|(知覚などが)鋭い
stiff|硬直した
vacant|(部屋などが)空いている
weary|疲れ果てた
superficial|浅い 表面的な
static|変化のない
tidy|(場所などが)整然とした
faint|かすかな
obscure|(意味などが)わかりにくい
savage|激しい
idle|使われていない 仕事がない
uneasy|落ち着かない
sore|(炎症などで)痛い
sour|酸っぱい
humid|湿気のある
loyal|(・・・に)忠実な
infinite|無限の
eternal|永遠の