last|続く、持続する、(天候・体力・食品などが)持ちこたえる
affect|に影響を及ぼす；を感動させる
claim|と主張する；を（自分のものとして）要求する
ship|を出荷する、を輸送する
issue|問題（点）；発行（物）；発表
purchase|を購入する
occur|起こる；心に浮かぶ；現れる
deal|を処理する；を商う；を分配する
consume|を消費する；を食べる，飲む
present|を提示する、を進呈する
fire|を解雇する、を首にする
regard|を見なす；を見る；を評価する
fine|に罰金を科す
transfer|を移す；を伝える；移る；乗り換える
decline|減少する；衰退する；を断る
eliminate|を取り除く
indicate|を指し示す；を述べる
ensure|を確実にする（≒make sure）；を守る
expand|（を）拡大する；（を）詳説する
address|（問題など）に対処する；に演説する；（手紙など）を（～宛てに）出す（to）
identify|を特定する；を（～と）同一視する（with）
construct|を建設する（＝build）；を構成する
invest|（を）投資する；に（～を）与える（with）
obtain|を得る
struggle|闘い；懸命の努力
counter|～と反論する、～に反対する
associate|を結び付けて考える；（～と）交際する（with）
register|を記録する，登録する；（～に）登録する（for）
reveal|を明らかにする；を見せる
species|（生物の）種；種類
diet|(日常の)食べ物、療養食
site|用地，場所；跡地；（ウェブ）サイト
cell|細胞；独房；電池
facility|施設，設備；機能；才能
practice|実践，実行；（社会の）慣習；練習
resident|居住者；滞在者
option|選択（の自由）；選択肢
organ|器官，臓器；組織；（パイプ）オルガン
critic|批判する人、批評家
region|地域；領域；部位
tax|税金、税
access|利用，入手；接近（の機会・方法・権利）
virus|ウイルス；（感染症の）病原体
bill|請求書；【英】勘定書（≒【米】check）；法案
evidence|証拠
attempt|を試みる，企てる
account|説明；勘定；口座
theory|学説；理論；原理；推測
factor|要因、要素
stock|在庫品；蓄え；株
chemical|化学の，化学的な
media|マスメディア、マスコミ
income|収入；所得
supply|を供給する
shortage|不足、欠如
poverty|貧困、欠乏
criminal|犯人、犯罪者
budget|予算；経費
authority|〔通例 the ～ties〕（関係）当局；権威；権限
genome|ゲノム
atmosphere|〔the ～〕大気；雰囲気
aid|を援助する，助ける（≒help）
measure|措置、程度、基準
subject|話題；科目；主題；被験者
decade|10年間
weapon|兵器，武器（≒arms）
nutrient|栄養分、栄養になるもの
expense|〔～s〕経費；費用；犠牲
structure|構造；体系；構造物
adolescent|青年
procedure|手順、手続き
minimum|最小限度
fuel|燃料；勢いを増加させるもの
resource|〔通例～s〕資源；〔通例～s〕資金；才覚
regulation|規則、規制
contract|契約（書）；協定
insurance|保険；保険料；保険金
employment|雇用、職
ban|を（法的に）禁止する；を締め出す
vehicle|車、(特に陸上の)乗り物、輸送機関、伝達手段
soil|土地，土壌；（悪事などの）温床
cargo|(主に船・飛行機の)積荷、貨物
aircraft|航空機、飛行機
current|現在の；現代の；通用している
political|政治（上）の
significant|重要な，重大な；意義深い
effective|効果的な、有効な
military|軍の，軍事（用）の
due|予定された；（支払）期日で；しかるべき
essential|（～に）必要不可欠な（to/for）；本質的な
illegal|違法の、非合法の
immune|（～に対して）免疫を持つ（to）；（～を）免れた（from）
numerous|非常に数の多い
extreme|極端な；極度の，過激な
general|全体の、一般的な
agricultural|農業の、農耕の
overall|総合的な；全体的な
additional|追加の、付加的な
entire|全体の，全部の（≒whole）；完全な
severe|（人・規律・事態・天気などが）厳しい；猛烈な
alter|を変える；変わる（≒change）
adopt|を採用する；（態度など）をとる；を養子にする
vote|投票；投票結果；〔the ～〕選挙権
determine|を決定する；を正確に知る
enable|（人）が...できるようにする；を可能にする
conduct|（調査・実験など）を実施する；を導く
direct|を案内する、を指揮する
absorb|を吸収する；を併合する；を夢中にさせる
imply|を暗に意味する；を必然的に伴う
operate|を操作する；機能する；手術する
demonstrate|を論証［証明］する；デモをする
boost|を押し上げる；を増加させる
prove|を証明する；判明する，わかる
monitor|を監視する；を傍受する
defeat|を負かす（≒beat）；を失敗させる
protest|（に）抗議する；を主張する
target|（到達・攻撃）目標；的
preserve|を保存する；を保持する；を保護する
oppose|に反対する；を対抗［対比］させる
migrate|移住する；（鳥などが）渡る
analyze|を分析する
discourage|（人）にやる気をなくさせる；を落胆させる
confirm|を確認する；を裏づける
intend|を意図する
predict|を予言［予測］する
extend|を伸［延］ばす；伸びる；及ぶ
figure|数字；姿；人物；図表
transportation|交通[輸送]機関、輸送
institution|機関；協会；施設；制度
theft|窃盗（罪）
candidate|（～の）候補（者）（for）；志願者
mammal|哺乳動物
economist|経済学者
protein|たんぱく質
immigrant|(外国からの)移住者、移民
property|不動産、財産、特性
fund|〔しばしば～s〕基金，資金
habitat|生息地；（人の）居住地
symptom|症状；兆候（≒sign）
eruption|勃発、噴火
quantity|量；分量
ad|広告
saving|節約、倹約、預金(額)、蓄え
territory|領土；（活動の）領域；（動物の）テリトリー
threat|脅威；（悪い）兆し；脅迫
sufferer|苦しむ人、被災者、病人
emission|排気、放出(物)
executive|重役、幹部、経営者
strategy|戦略
riot|暴動
district|地区；行政区
election|選挙
medication|(医師が処方した)薬、医薬品、薬物治療
breed|を繁殖させる，育てる；繁殖する
conflict|争い；論争；不一致
productivity|生産性
organism|有機体、生物
representative|代表者、代理人
warehouse|倉庫
refund|返金、払い戻し(金)
tuition|【主に米】 授業料；（個人）指導
range|範囲、領域
victim|犠牲（者），被害者
dose|（薬の1回分の）服用量；放射線の1回の照射量
mainland|本土
waterfall|滝
satellite|人工衛星、衛星
evolution|進化、発展、展開
prey|獲物；犠牲者
bystander|傍観者
creature|生き物、(特に人以外の)動物
civilization|文明
tribe|部族；仲間
permission|許可、承認
barrier|（～に対する）障壁（against/to）；防壁
wage|賃金、給料
drone|ドローン、(無線操作の)無人機
appearance|外観、出現
embassy|大使館；大使一行
skeleton|骨格；骨組み；概略
wildlife|野生生物
potential|潜在的な；可能性を秘めた
limited|限定された、わずかの
rural|田舎の（⇔urban），田園の
advanced|進歩した、前進した、上級の
beneficial|有益な、有利な
genetic|遺伝子の
radical|急進的な；根本的な
hostile|敵意のある（⇔friendly 友好的な）
fit|健康な、元気な、ふさわしい
long-term|長期にわたる、長期的な
Arctic|北極の
minor|重要でない；小さい
risky|危険な
complex|複雑な、複合(体)の
competitive|競争力のある、格安の、競争の
immediate|即座の；当面の；すぐそばの；直接の
religious|宗教(上)の、信仰があつい
related|関連した、関係のある
affordable|手頃な、安価な
donate|を寄付する；（臓器・血液）を提供する
lessen|を減らす
manufacture|を製造する；をでっち上げる
commute|通勤［通学］する
exaggerate|（を）誇張する；を強調する
suspect|ではないかと思う；（人）を疑う
acquire|を得る；を習得する
reintroduce|(動植物など)をかつての分布域に再導入する、(制度など)を復活させる
reschedule|の日時を変更する
adapt|適応する；を（～に）適合させる（to）
generate|を生み出す；（電気など）を発生させる
guarantee|を保証する
dump|を投棄する；をどさっと落とす
update|を最新のものにする；をアップデートする
classify|を分類する；を機密扱いにする
acknowledge|（事実など）を認める（≒admit, accept）；に謝意を表す
enforce|を施行［実施］する；を（～に）強制する（on/upon）
renew|を更新する；（資源）を再生する
overlook|を見落とす；を大目に見る；を見渡す
evaluate|を評価する；を査定する
commit|献身する；（罪など）を犯す；を投入する
argument|議論、口論
archaeologist|考古学者
reputation|評判；名声
fossil|化石；時代遅れの人［物］
status|地位；状態
contrast|（～との）対照（with/to）
workplace|職場
equality|平等
colleague|（職場の）同僚
assistance|援助、支援
luxury|ぜいたく（品）；〔形容詞的に〕豪華な
outbreak|発生，勃発
council|（地方）議会；評議会；（公の）会議
pottery|陶器類、焼き物類
assignment|任務、宿題、割り当て
particle|（微）粒子；ほんのわずか
radiation|放射能，放射線
priority|優先（事項）
content|内容，中身；コンテンツ
destination|(旅行などの)目的地、行き先
mine|鉱山、地雷
injury|傷害、けが
lottery|宝くじ、抽選
feature|特徴、特集記事
labor|労働、労働力
diabetes|糖尿病
bulb|電球、球根
résumé|履歴書[≒CV]、要約
mud|ぬかるみ、泥
psychology|心理学；心理（状態）
corporation|（大）企業；法人
ecosystem|生態系
promotion|昇進、促進、販売促進
administration|管理（部）；行政；政府（機関）
complaint|苦情、不平
debt|借金，負債；恩義
requirement|必要条件、必需品
workforce|労働人口，総労働力；全従業員（数）
preference|他より好むこと、好み
refugee|難民、亡命者
inhabitant|居住者、住民
subscription|予約購読(料)、寄付(金)
recipient|受け取る人；（臓器などの）被提供者
shift|を変える，移す；変わる；移動する
vessel|船舶；容器；（体液が通る）脈管
ingredient|材料，成分；（成功の）要因
qualified|有能な、資格のある、適任の
widespread|広範囲にわたる；広く普及した
alternative|代替の、どちらか一方の
harsh|厳しい；（光・色・味などが）不快な
enormous|莫大な，巨大な
specific|明確な、特定の
artificial|人工の（⇔natural 自然の）；不自然な
toxic|有毒な；中毒性の
flexible|融通の利く，柔軟な
latest|最新の、最近の
former|以前の、元の
capable|能力がある；有能な
practical|実践的な、実際的な
mechanical|機械の；機械的な
federal|連邦（政府）の
aggressive|攻撃的な；意欲的な
adequate|十分な；適切な
unexpected|思いがけない，不意の
attractive|魅力的な
sufficient|十分な（for ～に, to do ～するのに）
costly|費用のかかる、高価な、犠牲[損失、労力]の大きな
eventually|ついに(は)、結局(は)
otherwise|そうでなければ、そのほかの点では
previously|以前に
relatively|比較的(に)、相対的に
consequently|その結果(として)、従って
constantly|絶えず、常に
typically|通常、概して、典型的に
barely|かろうじて、ほとんど～ない
despite|～にもかかわらず
per|～につき、～ごとに
beneath|～の下に[の]
whereas|～するのに（対し），～する一方
post|(インターネットで)(情報・メッセージ)を投稿する、(ビラなど)を張る
reject|を拒否する
consult|（に）相談する；を参照する
obey|に従う；に服従する
engage|を従事させる；を（～として）雇う（as）；（～に）従事する（in/with）
restore|を回復させる；を修復する
colonize|を植民地化する、を入植させる
interact|影響し合う；相互に作用する
inspire|（人）を奮起させる；を喚起する
sue|を告訴する；（～を求めて）訴訟を起こす（for）
estimate|～と推定する、を見積もる
strengthen|を(より)強くする
carve|を彫る；を切り開く；（肉）を切り分ける
convince|を納得［確信］させる
propose|を提案する；をもくろむ；結婚を申し込む
blame|を責める；の責任を負わせる
collapse|崩壊する；（人が）倒れる；を折り畳む
import|を輸入する；を取り込む
load|に積む；に負わせる
pollute|を汚染する
spot|(特定の)場所、斑点、しみ
prescription|処方箋、処方
duty|義務；〔しばしば～ties〕職務；関税
union|組合、統合、団結
concept|概念
root|根本、源、(植物の)根
survival|生き残ること、生き延びること
maintenance|保守、整備、維持
formation|形成；構成（物）；隊列
educator|教育者、教師
kidney|腎臓
nutrition|栄養（の摂取）
brand|ブランド、銘柄
storage|保管、貯蔵(法)、収容力
firm|確固たる；堅固な；安定した
statistics|統計；統計学
toll|損害（の程度）；死傷者数；通行料
tip|助言，秘訣；チップ；先端
CEO|最高経営責任者
circumstance|〔通例～s〕状況，事情；境遇
outsider|部外者、門外漢
reduction|減少、削減
settlement|開拓地、解決、合意
divorce|離婚；分離
likelihood|可能性、見込み
livestock|(牛・羊・豚などの)家畜(類)
possession|所有物、財産、所有
plot|（小説などの）筋；陰謀
category|部類，区分；範疇
welfare|福祉，幸福
moisture|水分；湿気
obesity|（病的な)肥満
grant|（人）に（許可・権利など）を与える；を認める
layer|層
secretary|秘書
anxiety|不安、心配
ownership|所有権、所有者であること
foundation|基礎、基盤
division|不和、分割、部門、仕切り
establishment|設立、制定、組織
conservation|（動植物などの）保護；保存
murder|殺人
presence|存在；出席；面前
paradox|逆説；矛盾
prisoner|囚人
surgeon|外科医
frequency|頻度、しばしば起こること
port|港
reception|反応；宴会；受付；受信（状態）
coworker|同僚、仕事仲間
rust|さび
athletics|スポーツ、運動競技
voyage|(ゆったりした長い)旅、船旅
ecologist|生態学者、環境保護論者
soul|精神；魂，霊魂；生気
isolated|孤立した、孤独な
biased|偏った、偏見を持った
multiple|多様な；種々雑多な
critical|批判的な、重大な
remote|（～から）遠く離れた（from）；かけ離れた
encouraging|勇気づける、望みを持たせる
underground|地下の、秘密の
stable|安定した；動じない
domestic|家庭の；国内の；（動物が）飼いならされた
shallow|浅い（⇔deep 深い）；浅薄な
willing|～するのをいとわない、快く～する
superior|よりすぐれた
profitable|利益になる、有益な
solid|しっかりした；硬い；固体の
tremendous|途方もない，莫大な；すばらしい
intellectual|知的な、知性の
chief|主な、最高位の
steady|着実な，一定の；安定した
evil|邪悪な；有害な
coastal|沿岸(地方)の
dairy|〔集合的に〕乳製品；乳製品加工所［販売者］
digestive|消化の
loyal|（～に）忠実な（to）；誠実な
sensory|感覚の
fancy|（気まぐれな）好み；空想；思いつき
spoil|を台無しにする；を甘やかす；だめになる
stimulate|を刺激する
distract|（注意など）をそらす
bargain|買い得品；取引；契約
emerge|明らかになる、現れる
browse|（を）拾い読みする；（を）閲覧する；（商品など）を見て歩く
define|を定義する、を明確に示す
adjust|を調整する；を適合させる；順応する
deserve|に値する
undergo|を経験する；（手術など）を受ける；に耐える
contradict|と矛盾する；に反対意見を言う
withdraw|を引き出す；を撤回する；撤退する
accompany|に同行する；に付随する
infect|(人)を感染させる、を汚染する
rebel|反逆者
convert|を変える；を改宗［転向］させる；を交換する
calculate|を計算する；を予測する
utilize|を利用する（≒make use of）
admit|～と(しぶしぶ)認める、を中に入れる
punish|を罰する；に損傷を与える
approve|賛成する；を承認する
owe|に借りがある；のおかげである
proceed|進む，進行する；（～を）続行する（with）
navigate|（を）誘導する；（を）操縦する；（を）航行する
postpone|を延期する（≒put off）
swallow|（を）飲み込む；をうのみにする；に耐える
tailor|を合わせて作る
overhear|を偶然耳にする
consequence|結果、重要さ
application|申請書、申し込み、適用
workout|運動、(運動競技の)練習
obstacle|（～に対する）障害（物）（to）
treaty|（国家間の）条約；協定
deforestation|森林伐採
infrastructure|基本的施設；（経済）基盤
contribution|貢献、寄付(金)
congestion|混雑
exposure|身をさらすこと、暴露
blow|強打、打撃、災難
participation|参加
crisis|危機、難局
ancestor|先祖、祖先
architect|建築家、設計者
existence|存在、生存
deposit|を置く；を預ける；を堆積させる
finance|金融、財政(学)
awareness|認識、意識
intake|摂取量；受け入れ数；取り入れること
witness|目撃者；証人；証拠，証言
coverage|報道、(保険の)補償範囲、適用範囲
lawsuit|(民事)訴訟
session|集まり；（議会の）会期；（開会中の）議会
means|〔単数・複数扱い〕手段；〔複数扱い〕資力，収入
pioneer|先駆者、草分け、(未開地の)開拓者
satisfaction|満足
basis|根拠、基礎
element|(構成)要素、成分
phenomenon|現象、事象
scale|規模、程度
journal|(専門)雑誌、日刊[週刊]新聞
grain|穀物；粒；きめ
continent|大陸、(イギリスから見て)ヨーロッパ大陸
headquarters|本社、(軍・警察・会社などの)本部
globalization|国際化
brochure|パンフレット、小冊子
inspection|検査、点検
attendance|出席[入場]者数、出席
copper|銅
dozen|12(個)、１ダース
flu|インフルエンザ
burial|埋葬
mold|鋳型；鋳物；性格；かび
patch|（～の）部分，斑点；継ぎ；貼り薬
diagram|図(表)
placement|(就職先・学校・里親などの)斡旋、配置
shame|恥；残念なこと
wheelchair|車椅子
experienced|熟練した
initial|初めの
mainstream|（活動・思潮などの）主流；大勢
appropriate|適切な
fake|偽の；見せかけだけの
alert|警戒して；敏速な
fatal|致命的な、破滅的な
nutritious|栄養になる
sophisticated|高性能の，精巧な；洗練された
automatic|自動の
raw|生の；未加工の
slight|わずかな；取るに足らない
man-made|(物質などが)合成の、人工の
aging|高齢化が進む、老朽化している
spiritual|精神の（⇔material）；霊的な
endangered|(動植物が)絶滅の危機にある
sticky|ねばねばの、粘着性の
fertile|肥沃な（⇔barren 不毛の）；多産の
elsewhere|どこかほかのところへ[に、へ]
altogether|完全に
strictly|厳格に、厳しく
beforehand|前もって、あらかじめ
likewise|同様に（≒in the same way）
detect|を感知する；を見つけ出す；に気づく
combat|戦闘；対立
pose|（危険）を引き起こす；（問題など）を提起する；（～を）装う（as）
emphasize|を強調する；を重視する
highlight|を目立たせる，強調する
resist|に抵抗する；〔通例否定文で〕を我慢する
exceed|を超える；に勝る
relocate|(住居・事務所・住民など)を移転[移動]させる
disprove|の誤りを証明する、の反証を挙げる
crawl|はう；ゆっくり進む
foster|をはぐくむ；を養育する；を心に抱く
harass|を絶えず悩ます、を苦しめる
magnify|を拡大する、を誇張する
sneak|こっそり動く
stray|はぐれる，（道に）迷う
worsen|を悪化させる；悪化する（≒deteriorate）
advocate|を主張する；を擁護する
evacuate|を避難させる、から立ち退く
verify|の正しさを証明［確認］する
abuse|乱用；虐待
scatter|をまき散らす；分散する
endorse|を推奨する
modify|を修正する；を緩和する
penetrate|（に）浸透する；（に）進出する；（を）貫く；（を）見抜く
conform|順応する；一致する
leave|休暇
tissue|（生物の）組織
gut|腸、消化管、内臓
lightning|雷、稲妻
camel|ラクダ、黄褐色
antioxidant|抗酸化物質、酸化防止剤
disorder|障害，（心身の）不調；混乱
cattle|〔集合的に〕牛
oath|誓い、誓約
monument|記念碑，遺跡；金字塔
heating|暖房(装置)
germ|細菌、病原菌
legend|伝説、言い伝え、伝説的な人物
auditorium|(学校の)講堂、公会堂
therapy|療法；心理療法
heritage|遺産
invasion|侵害、侵入
instruction|(製品の)使用書、指示、教育
extinction|(家系・種などの)絶滅、消滅
creativity|創造性、独創性
plantation|(熱帯・亜熱帯の)(大)農園
drought|干ばつ；（慢性的な）不足
wealth|財産、富、豊富
reminder|思い出させるもの、記念物[品]
inquiry|問い合わせ、質問、調査
investigation|(詳しい)調査、研究
boundary|境界（線）；〔通例～ries〕限界
compartment|(列車・客室などの仕切った)区画[部屋]
substitute|を代わりに使う；（～の）代理をする（for）
hybrid|雑種の；混成の
characteristic|特徴
routine|決まり切った仕事；いつもの手順
edge|優勢、刃、端
incident|出来事，事件；紛争
clue|（～の）手がかり（to/about）；（パズルの）ヒント
removal|除去、移動
outcome|結果
altitude|高度，標高
closure|(工場・学校などの)閉鎖
compound|を悪化させる；を合成する；を混合する
surplus|余剰（⇔shortage 不足），過剰；黒字
vaccine|ワクチン
reference|言及、参照
obligation|義務、責任
ritual|儀式；（日常の）習慣的行為
mean|意地の悪い、不親切な
coral|サンゴ(製)の
novel|斬新な、目新しい
relevant|関係がある；適切な
efficient|効率的な、有能な
fragile|壊れやすい；虚弱な
impressive|印象的な、感動的な
offensive|不快な、攻撃的な
distinct|明らかに異なる；明瞭な
temporary|一時的な（⇔permanent）
arrogant|横柄な，傲慢な
spacious|広々とした
reasonable|筋の通った、分別のある、(値段などが)手ごろな
substantial|(数量などが)かなりの、重要な、実質的な
disabled|障害のある；障害者用の
straightforward|単純な；率直な
tame|飼いならされた，人に慣れた；退屈な
mandatory|義務的な、強制的な、命令の
edible|食用の，食べられる
outstanding|際立った；未払いの；未解決の
deadly|致命的な、命にかかわる
petty|低級の、心の狭い、取るに足らない
definitely|間違いなく、確かに
roughly|おおよそ、乱暴に
virtually|ほとんど、実質的に
apparently|(真偽のほどはともかく)聞いた[見た]ところでは、どうやら
unfairly|不当に、不公平に
briefly|少しの間に、簡潔に
aside|わきに、別にして、考慮に入れないで
legally|法的に、合法的に
resort|（好ましくない手段に）訴える，頼る（to）
submit|を提出する；（～に）従う（to）
originate|由来する、生じる、始まる
regret|を後悔する、を遺憾に思う
cooperate|協力する
revise|を修正する；を改訂する
restrict|を制限する
occupy|（空間・時間）を占める；を占領する
fade|薄れる；衰える
relieve|を和らげる；〔受身形で〕（...して）安心する（to do）；を解放する
suppress|を抑える；を抑圧する
starve|飢える；（～を）渇望する（for）；を飢えさせる
scratch|を引っかく；を取り消す，削除する
unite|団結する、一体化する
grip|を握る；をとらえる
surrender|を放棄する，引き渡す；（～に）屈する（to）
twist|をねじる，ひねる；を歪曲する
remodel|を改装する、を改造する
triple|３倍になる、を３倍にする
drown|溺死する；を水浸しにする
lean|傾く；寄りかかる；をもたせかける
soak|を浸す；をずぶぬれにする；浸る
hover|(鳥・昆虫・ヘリコプターなどが)空中(の一点)に止まる
interrupt|を中断させる；（の）邪魔をする
socialize|(社会的に)交際する
termite|シロアリ
microbe|微生物；細菌
beverage|（水以外の）飲み物，飲料
paperwork|(必要)書類、書類事務
descendant|子孫
sculpture|彫刻（作品）
handout|(講演・授業などの)配布物、プリント
replacement|交換、交替、代わりの人[もの]
minister|大臣
stream|小川
predator|捕食動物；略奪者
observer|監視員、観察者
commission|代理手数料、歩合、委員会
committee|委員会
junk|がらくた、つまらないもの
departure|出発
description|描写、説明
supervisor|監督者；指導教員
guidance|指導、案内
landscape|眺め、風景、景色
crew|(船の)乗組員、(飛行機・列車などの)乗務員
drain|（液体）を流出させる；（液体が）流れ出る
stereotype|固定観念、ステレオタイプ
edition|(刊行物の)版
graphic|図、挿絵
pathway|小道、細道
reunion|再会（の集い）；再結合
cliff|崖、絶壁
coordinator|コーディネーター、取りまとめ役、責任者
depth|深さ、深み
liver|肝臓
monopoly|独占（権）
usage|（使）用法；語法；習慣
chart|図，グラフ；海図；ヒットチャート
expectancy|期待、見込み
nowhere|どの場所も～ない
courthouse|裁判所(の建物)
cove|入江、小湾
dock|埠頭、波止場、(艦船の)ドック
ministry|省
inflammation|炎症、点火、引火
cholesterol|コレステロール
gender|(社会的・文化的)性別、ジェンダー
depression|うつ病、意気消沈、不景気
stem|（草木の）茎，幹
personnel|〔集合的に〕職員，社員
controversy|論争
recognition|(人・物が)それと分かること、認めること、認識
applicant|応募者、志願者
anthropologist|人類学者
sewage|下水
acceptable|受け入れられる、容認できる
nuclear|原子力利用の、核エネルギーの
moral|道徳(上)の、倫理的な
marine|海の；船舶の
conventional|伝統的な、型にはまった
awful|ひどい；嫌な；ものすごい
consistent|着実な、安定した、首尾一貫した
primitive|原始的な；未開の
mature|成熟した；熟した
unfamiliar|（～に）不慣れな（with）；（～に）（よく）知られていない（to）
impractical|実用的ではない、非現実的な
unpredictable|変わりやすい、予測できない
misleading|誤解させる、紛らわしい
plentiful|豊富な、十分な
Mediterranean|地中海(沿岸地域)の
unsafe|安全でない、危険な
bare|露出した、裸の
feeble|病弱な、(体が)弱々しい
horrible|実にひどい、ぞっとする
scenic|景色の良い
supplementary|補足の、追加の
nosy|詮索好きな、おせっかいな
intermediate|中級の；中間の
universal|(あらゆる人に)共通の、全員の、普遍的な
capture|を捕らえる、を捕虜にする
arise|起こる、出現する
implement|を実行［実施］する
reproduce|を複製する；を繁殖させる；繁殖する
seize|をつかむ；を奪い取る；を没収する
dominate|を支配する、優勢である
complicate|を複雑にする
scan|を走査する；をざっと見る；を注意深く調べる
negotiate|交渉する；を（交渉して）取り決める
illustrate|を説明する、を例示する
encounter|に遭遇する
confine|を限定する；〔通例受身形で〕閉じ込められる
transmit|を伝える；（電波・信号など）を送る
administer|を管理する、を経営する、を治める、(治療)を施す
ease|を和らげる、緩和する
resume|（を）再開する；を取り戻す
pursue|を追跡する、を追求する
decay|腐敗する（≒rot）；（徐々に）衰える
shrink|縮む，縮小する；減少する；ひるむ
cherish|を大切にする；を心に抱く
launch|を売り出す、を開始する、(ロケットなど)を発射する
accommodate|を収容する；を（～に）適応させる（to）
withstand|に耐える
halt|を止める；止まる
transform|を大きく変える
transplant|を移植する；を移住させる
retail|小売り（⇔wholesale 卸売り）
abandon|を捨てる、を放棄する
developer|宅地造成業者、開発者
circulation|循環；流通；（新聞・雑誌の）発行部数
appliance|(特に家庭用の)器具
bond|きずな、債券、契約
circuit|周回すること、回路、巡回
innovation|(技術)革新、新機軸
infant|幼児、乳児
transaction|（商）取引；（人と人との）交流
celebrity|有名人、著名人
checkup|健康診断、検査
makeup|化粧；化粧品；構成；性質
respondent|(調査・アンケートなどの)回答者
well-being|健康、幸福
flaw|欠点、傷、ひび
strain|に負担をかける；を緊張させる；を漉す
rivalry|ライバル意識、競争
publicity|一般に知られること、評判、宣伝
consent|同意，承諾
addiction|依存
profession|職業；専門職；同業者仲間
sacrifice|犠牲；いけにえ
nerve|神経；〔～s〕神経過敏；（...する）度胸（to do）
assumption|(確証のない)仮定、想定、思い込み
context|文脈、背景、状況
era|時代
trait|特徴、特色
voucher|クーポン券、商品券
draft|下書き；為替手形；隙間風
blaze|炎、強いか輝き
currency|通貨、普及
stance|立場、対処の姿勢
fluid|流動体，液体
dispute|に異議を唱える；（を）議論する
counterpart|相当する物［人］
perception|認識、知覚
custody|親権、保護、管理、拘留
venue|会場、開催地
dread|をひどく恐れる
incentive|動機（づけ）；報奨金
disgust|をむかつかせる；に愛想を尽かせる
province|州，省；〔the ～s〕地方；分野
proponent|支持者
commercial|商業(上)の、営利的な
excessive|過度の、法外な
vulnerable|（攻撃などに）弱い，もろい；傷つきやすい
protective|保護する、守ろうとする
secure|安全な、確かな
obvious|明らかな
reluctant|気が進まない，嫌がる（⇔willing）
confident|確信して、自信に満ちた
intelligent|知能の高い、利口な
barren|不毛の、作物ができない
epidemic|流行（病）；蔓延
reliable|信頼できる
curious|好奇心の強い、詮索好きな
hasty|急ぎの、早まった
behavioral|行動の
bulky|かさばった、扱いにくいほど大きい
faulty|(機械・装置などが)欠陥のある
hectic|やたらと忙しい
knowledgeable|よく知っている、物知りの
tense|張り詰めた，緊張した
intact|損なわれていない，手つかずの
comprehensive|包括的な、広範囲にわたる
hesitant|ためらいがちな
scarce|乏しい；珍しい
defensive|防御的な
permanently|永遠に、いつも
nonetheless|それにもかかわらず，それでもなお
primarily|主として、初めに
intentionally|故意に、意図的に
abruptly|突然に
outsource|を外注する、を業務委託する
applaud|に拍手する、を賞賛する
bribe|賄賂
replicate|(同一実験など)を繰り返す、を複製する
stroll|散歩する、ぶらぶら歩く
swell|膨張する，腫れる；を膨らませる
uphold|を支持する、を確認する、を維持する
vomit|吐く、もどす
expire|期限が切れる
recruit|を募る；に新人を補充する
enhance|を高める、を増す
accumulate|を蓄積する，集める；積もる
designate|を指定する；を任命する
conceal|を隠す（≒hide）；を秘密にする
disregard|を無視する；を軽視する
accelerate|を加速させる，促進する；加速する
revive|を復活させる；復活する
enact|(法案)を制定する、を通過させる
exert|を及ぼす；（力など）を行使する
leak|漏れる；を漏らす
jail|刑務所，拘置所（≒prison）
reform|を改革する、を改善する
declare|を宣言する、を断言する
outline|の要点を述べる；の輪郭を描く
annoy|をいらいらさせる、を悩ます
interfere|干渉する，介入する；邪魔する
nest|(鳥の)巣
founder|創設者
biologist|生物学者
arrangement|準備、配置、取り決め
landfill|ごみ埋め立て地
trunk|(木の)幹、(象の)鼻、(自動車の)
principle|(個人の)主義、信条、原則
series|連続、一続き
independence|独立、自立
exploration|探検、調査
justice|正義、公正、司法、裁判
humanity|人類
involvement|関与、巻き込まれること
accounting|経理、会計(学)
discrimination|（～に対する）差別（against）；区別
inequality|不平等
master|修士
millennium|千年間，千年紀
refusal|拒否、拒絶
wound|（銃弾・刃物などによる）傷；痛手
absence|不在、欠席
distribution|分配、配給
wilderness|荒野；（庭・町などの）放置された部分
concentration|濃度、集中、専念
craft|工芸品、(手先でする)作業
crust|地殻、パンの耳、(動物の)甲殻
basement|地階、地下室
janitor|(アパート・ビル・学校などの)用務員、管理人
prejudice|偏見、先入観
prosperity|繁栄、繁盛
robbery|強盗(事件)
warranty|保証(書)
appetite|食欲；欲求
bullet|銃弾
preparation|準備、支度
citizenship|市民権、公民権、市民[国民]であること
stale|(パンなどが)堅くなった、鮮度の落ちた、陳腐な
disadvantaged|(経済的・社会的に)恵まれない
ongoing|継続している，進行中の
sturdy|頑丈な、たくましい、不屈の
unauthorized|権限のない、(公的に)認可されていない
verbal|口頭での、言葉の[に関する]
weary|疲れ果てた；（～に）うんざりした（of）
equivalent|相当する、同等の
intense|極度の、激しい
consecutive|連続した
noticeable|著しい、目立つ
crucial|重大な、決定的な
electrical|電気の、電気を扱う
steep|（傾斜が）急な；急激な；法外な
civil|(軍人・官史に対して)民間の、一般市民の
supreme|最高の
elite|えり抜きの
broad|(幅の)広い、広範囲な
industrial|産業の、工業の
allied|連合の、同盟を組んだ
external|外部の；対外的な
mere|ほんの、単なる
latter|後半の、後ろの方の、後者の
presidential|大統領の[による]、社長の
ethical|倫理(上)の、道徳の
realistic|現実的な、実際的な
harmless|害のない
underlying|潜在的な、根本的な
urgent|緊急の
complimentary|無料の、賞賛する
eager|熱望して、熱心な
loudly|大声で、騒々しく
accordingly|それ相応に、従って、そんなわけで
occasionally|ときどき
smoothly|順調に、滑らかに
frankly|率直に、正直に
notably|とりわけ
continuously|連続して、継続して
compel|（人）に強いて～させる
distinguish|区別する、を区別する
heighten|を高める、を増大させる
ruin|を台無しにする、を駄目にする
equip|に備えつける
export|を輸出する
glance|ちらりと見る
notify|に知らせる
overdo|を使い過ぎる、をやり過ぎる
pierce|に穴を開ける、を突き通す
overestimate|を過大評価する[見積もる]
raid|(警察が)に手入れを行う、(軍隊が)を襲撃する
recall|を思い出す、(商品など)を回収する
simplify|を簡単にする
wrinkle|(顔などに)しわを寄せる、(衣装など)にしわを作る
conspire|陰謀を企てる、共謀する
imitate|をまねる、を見習う
inhale|を吸い込む
overrate|過大評価される
sympathize|同情する
glide|滑らかに動く、音もなく移動する
kidnap|を誘拐する
pretend|のつもりになる、～するふりをする
simmer|(煮立たない程度に)こことこ煮える[≒boil gently]
thaw|解凍される、溶ける
unfold|（閉じたもの）を開く；を明らかにする；開く；明らかになる
detain|を勾留[留置]する、(人)を引き留める
puncture|(タイヤ)をパンクさせる、に穴をあける
strangle|(発展・活動など)を抑圧する、を窒息させる
hygiene|衛生（状態）；健康法
oppression|抑圧、虐待
collaboration|合作、共同、協力
harbor|港、避難所
lawn|芝生
pedestrian|歩行者
racism|人種差別(主義[政策])
summit|(先進国)首脳会議、サミット、(山などの)頂上
bug|病原菌（が起こす病気）；虫；盗聴器；（機械・プログラムの）欠陥
dirt|汚れ、泥、ほこり
maternity|妊産婦の、母であること
stroke|脳卒中；（ボールを）打つこと；（雷などの）一撃
tale|(事実・伝説・架空の)話、(文学作品としての)物語
certainty|確実性、確信
imbalance|不均衡、アンバランス
incidence|発生(率)
pit|穴、くぼみ
texture|感触，手触り；本質；質感
thumb|(手の)親指
undergraduate|学部学生
wisdom|知恵、賢明さ
bride|花嫁、新婦
dictator|独裁者、専制君主
signature|署名；特徴
testament|あかし、証拠
attachment|添付ファイル、添付書類
bachelor|独身の男性、学士
blister|水ぶくれ
blockade|(港などの)封鎖、経済[通信]封鎖
condo|分譲マンション
invoice|明細請求書、納品書
leisure|自由な時間、余暇
meditation|瞑想、黙想
procession|(儀式などの)行列、行進
unrest|(社会的な)混乱、不安、(心の)動揺
equator|赤道
exhausted|疲れ果てた
problematic|問題のある、疑わしい
desirable|望ましい
geological|地質(学)上の
rash|早まった、軽率な
solitary|ひとりの、孤独の
uneven|でこぼこな、平でない
antique|骨董の，アンティークの；古風な
dense|密集した，密度の高い；（霧などが）濃い
economical|経済的な、安上がりな
fictional|架空の、フィクションの
gradual|徐々の，緩やかな
intimate|親密な；密接な
lengthy|長い、長時間の
ultimate|最終の、究極の
victorious|勝利を得た、勝ち誇った
witty|機知に富んだ
blurry|ぼやけた、不鮮明な
exceptional|例外的に優れた、まれな
finite|有限の、限られた
on-the-job|実地の、職場での
vacant|空いている
cheery|陽気な、元気な
cowardly|卑怯な、臆病な
immeasurable|計り知れない、果てしない、広大な
impaired|～に障害のある、弱った、損なわれた
impassable|(川・道などが)通行できない、(困難・障害などが)克服できない
inactive|不活発な、停止中の
inconvenient|不便な、不都合な
superstitious|迷信深い、迷信の
unpleasant|不愉快な、いやな
wicked|悪意のある、意地の悪い
ecological|環境の、生態(学)の
imaginary|想像上の、架空の
ripe|熟した；成熟した
disguise|を（～に）変装させる（as）；を偽る
curb|を抑制する、を制御する
restrain|を制止する；を規制する
stumble|よろけながら歩く；（～に）つまずく（on/over）
diminish|を減らす；減少する（≒decrease）
rotate|回転する；循環する；を回転させる
compress|を要約する、を短縮する、を圧縮して詰め込む
decode|(暗号・符号)を解読する
offset|を相殺する，埋め合わせる；をオフセット印刷にする
bid|（～に）の値をつける（for/on）；（挨拶）を述べる
burst|破裂する；（～を）突然始める（into）
overtake|を追い抜く；に追いつく（≒catch up with）；（災難・強い感情などが）を襲う
retain|を保持する
litter|(場所)を散らかす
prohibit|を禁止する
discipline|を罰する、を訓練する
yield|を産出する、屈する、(権利など)を譲る
sweep|（を）掃く；を一掃する；さっと通過する
dictate|を指図する；を書き取らせる；を規定する
inject|（人）に注射する，を注入する；を導入する
urge|に熱心に勧める
mimic|をまねる
roam|（を）歩き回る；放浪する
assess|を査定する、を評価する
boast|を誇る；（を）自慢する
drag|を引きずる；ぐずぐずする
repay|を返済する
overthrow|(政府・体制など)を打倒する
fulfill|(約束・任務など)を果たす、(条件・要求など)を満たす
doom|〔通例受身形で〕運命にある
affiliate|を提携させる、を合併する
assault|に暴行する；を攻撃する
testimony|証言、証拠
errand|（人の）使い，使い走り；用件
friction|不和；摩擦
coalition|連立、合同
influx|(人・物の)殺到、(水・空気の)流入
curse|悪態，ののしりの言葉；呪い；〔通例a ～〕災い
app|アプリ
visibility|視界、視野、目に見えること
fabric|織物，布（地）；構造
collision|衝突；対立
dioxide|二酸化物
orbit|軌道
trial|裁判、試験、試み
literacy|(特定分野の)知識、技能、読み書きの能力
scheme|計画（≒plan）；体系；陰謀
completion|完了、完成
expertise|専門的知識[技術、意見]
diploma|卒業[修了]証書、(学位・資格の)証明書
livelihood|生計、生活手段
motive|動機
recession|不況；後退
surrounding|周囲の状況、環境
fortune|財産、幸運、運命
token|(気持ちなどの)しるし、記念品
trace|跡、形跡
venture|危険を冒して進む；を思い切ってする
physician|内科医、医師
perspective|観点
physics|物理学
legislation|法律；立法
barn|家畜小屋、(農家の)納屋
daring|大胆な、勇敢な
transparent|透明な；明快な
tragic|悲惨な、悲劇的な
sinister|邪悪な、不吉な
striking|著しい、目立つ
plural|複数の、2つ[2人]以上の、複数形の
vital|必要不可欠な
sensitive|敏感な、傷つきやすい
remarkable|注目に値する、著しい
minimal|最小(限度)の
bankrupt|破産宣告を受けた；破綻している
authentic|本物の；信頼できる
moderate|適度な；穏健な
alien|異質の、外国の
prompt|迅速な
random|無作為の、任意の
decisive|決定的な、断固たる
inevitable|避けられない、必然的な
acid|酸性の；酸っぱい；辛辣な
climatic|気候(上)の、風土の
incredible|信じられない、驚くほどの
precise|正確な、厳格な
invaluable|極めて貴重な[高価]な
stern|厳しい；いかめしい
indifferent|無関心な（≒uninterested）
charitable|慈善の、慈悲深い
massive|大量の、大規模な、巨大な
comparable|匹敵する、同様の
irrational|不合理な
cynical|冷笑的な，皮肉な
overly|あまりに、過度に
literally|文字どおり、まさしく
voluntarily|自発的に
technically|厳密に(言えば)、専門[技術]的に
wholly|完全に、全く
approximately|おおよそ、ほぼ
uniquely|比類なく、独特に
bewilder|（通例受身形で）当惑する
clutch|をぐっとつかむ
discard|を捨てる
enlist|入隊する、参加する、(支持・協力)を得る
heed|(助言・警告など)に注意する
liberate|を解放する
overlap|（一部）重なる；（と）重複［共通］する
reconstruct|を再建する、を改変する
shriek|悲鳴をあげる、甲高い声[音]を出す
sprain|(足首・手首など)をくじく、を捻挫する
resent|に憤慨する
thrive|繁栄する，うまくいく；繁茂する
embrace|を抱擁する、を(喜んで)受け入れる
excel|（～で）秀でている（in/at）；に勝る
enroll|登録する，入会する；を登録させる
retrieve|（情報）を検索する；を取り戻す；を回復する
degrade|の面目を失わせる、の質[価値]を低下させる
reconcile|を（～と）一致させる（with）；を和解させる
contaminate|を汚染する；を堕落させる
disrupt|を混乱させる；を分裂させる
divert|（注意など）をそらす；を迂回させる；（資金など）を転用する
grumble|不平を述べる
provoke|（感情・行動など）を引き起こす；を挑発する
outweigh|より価値がある、より重い
crave|(を)切望する
sustain|を持続させる、を支える
disclose|を公表する，暴く
tempt|を（...する）気にさせる（to do）；を引きつける
resign|（を）辞任する；を放棄する
dismiss|を解雇する、(意見など)を退ける
surpass|を上回る
bounce|跳ねる；反射する；を弾ませる；（Ｅメールが）（宛先不明で）返送される
bureau|（官庁の）局；事務局；案内所
dependency|依存、従属
discomfort|不快、不便
drawback|欠点、不利な点
feast|祝宴；大ごちそう；楽しみ
hydrogen|水素
modernization|近代化、現代化、最新式化
objective|目的、目標
poll|世論調査、投票(数)、投票所
ration|(食料・物資などの)割当(量)
revenue|歳入（⇔expenditure 歳出）；収益
scholarship|奨学金、学識
upbringing|(子供の)養育、しつけ
compliment|賛辞
excerpt|抜粋、引用
faith|信仰(心)、信用
segment|部分、区分
downturn|(景気などの)下降(状態)
temper|気質，気性；機嫌；かんしゃく
fragment|断片
intersection|(進路の)交差点
anarchy|無秩序、無政府状態
breakup|(人間関係の)解消、別れ
privilege|特権
exemption|(義務・責任などの)免除
monarch|君主
narrative|話、物語
sensation|漠然とした感じ、感覚、大騒ぎ
apprentice|見習い(工)、初心者
chore|雑用、家事、いやな仕事
dehydration|脱水(症状)
questionable|疑わしい
outdated|時代[流行]遅れの、旧式の
forthcoming|来るべき
gross|総計の；甚だしい；粗野な
overdue|支払期限を過ぎた、(予定の日時より)遅れた
contemporary|現代の、現代的な、同時代の
drastic|徹底的な，抜本的な；極端な
conditional|～しだいの、条件付きの
subjective|主観的な
exotic|外来の；異国風の
intensive|集中的な、徹底的な
obscure|（世に）知られていない；不明瞭な
tedious|退屈な
exclusive|高級な、排他的な
decent|まずまずの；きちんとした；上品な
considerate|思いやりのある
durable|長持ちする、丈夫な
perpetual|永続的な；ひっきりなしの
proficient|堪能な、熟達した
acoustic|音響の；聴覚の；（楽器が）アコースティックの
biographical|伝記の
botanical|植物の、植物学(上)の
brutal|残酷な、無情な
commendable|賞賛されるべき、立派な
desperate|絶望的な、強く望んで、必死の
extravagant|浪費する、(要求などが)過度な
filthy|汚い、不潔な
serene|穏やかな、平静な
valid|法律的に有効な、理にかなった
inherent|生来の，本来的に備わっている
merely|単なる、ただの、単に
somehow|何とかして、とにかく
subsequently|その後、続いて
deliberately|故意に、慎重に
gently|優しく、静かに
via|～の手段によって、～経由で
alongside|～と一緒に、～と並んで
portray|を描く；（の役）を演じる
dispatch|を派遣する；を発送する；を処理する
quote|が～と述べたと伝える、を引用する
amend|を改正する、を修正する
betray|をうっかり表す；を裏切る
wither|(植物などが)しおれる
omit|を省略する
fabricate|をでっち上げる、を組み立てる
violate|（法律・規則など）に違反する；を侵害する
allege|を主張する
integrate|を統合する；融合する
underestimate|（を）過小評価する；（を）軽く見る；を少なく見積もる
escort|を護衛[護送]する、に付き添う
facilitate|を促進する、を容易にする
initiate|を新たに始める
convey|を伝える、を運ぶ
populate|に住む，の住民である；に人を住まわせる
reinforce|を補強する、を強化する
attain|を獲得する，達成する；に達する
cheat|(試験で)カンニングをする、をだます
deceive|をだます（≒take in）
frustrate|に不満を抱かせる、を挫折させる
subsidize|に補助金[助成金]を支給する
alternate|代わりの；交互の
dedicate|を捧げる
endeavor|～しようと(懸命に)努力する、を(真剣に)試みる
intrigue|に興味を持たせる；陰謀を企てる
soar|急上昇する；空高く飛ぶ
tease|（を）からかう；をいじめる
confer|(賞・学位・栄誉・権利など)を授与する、相談する
forbid|を禁じる
nod|(頭)を軽く下げる、うなずく
oblige|に義務づける；に恩恵を施す
discontent|不満
disposal|処分、売却
exile|亡命（者）；（国外）追放
foe|敵
itinerary|旅行の日程、旅行計画
persecution|迫害
publication|出版(物)、発行
riddle|なぞなぞ、不可解な人[もの、事実]
sanitation|公衆衛生（学）；下水［衛生］設備
component|構成部品[部分、要素]
quota|割当量[数]、ノルマ
cuisine|（独特の）料理，料理法
detour|迂回(路)、回り道
inmate|(刑務所などの)収容者、入院患者
fatigue|(相当の)疲労
uproar|大騒ぎ、騒動
coincidence|偶然の一致
correspondence|通信、一致
ballot|投票、投票用紙、投票総数
competence|能力、資格
enterprise|事業、企業
hazard|危険（要素）；偶然
explosion|爆発、急激な増加
famine|飢饉；（食糧・物資の）ひどい不足
acceptance|受諾、受け取り
leftover|(特に食事の)残りもの
apprehension|不安、懸念
wreck|残骸、難破(船)
landmark|（ある場所の）目印；画期的な出来事
dweller|居住者
geometry|幾何学
standby|(いざというとき)頼りになるもの(人)、交替要因
diversity|多様性
accuracy|正確さ、的確さ
tap|(水道などの)蛇口
brick|れんが
bay|入江、湾
lenient|寛大な
stubborn|頑固な，強情な（≒obstinate）；手に負えない
clumsy|不器用な
perilous|とても危険な
adverse|不都合な；逆の
persistent|執拗な、固執する、持続する
outrageous|法外な、途方もない、けしからぬ
skeptical|（～に）懐疑的な（of/about）
legitimate|合法的な；妥当な
corrupt|を堕落させる；を買収する；堕落する
experimental|実験の、実験[試験]的な
improper|不適切な、無作法な
spontaneous|自然発生的な；自発的な
unconditional|無条件の、絶対的な
counterfeit|偽造の、偽の
dizzy|目まいがする；当惑した
sustainable|持続できる、維持できる
democratic|民主主義の、民主的な
conservative|保守的な
fundamental|基本的な、必須の
ambitious|(計画などが)野心的な、(人が)大志を抱いた
concrete|具体的な、明確な、コンクリート製の
cruel|残酷な
inferior|劣悪な、劣った
ample|十分すぎるほどの；広い
inaccurate|不正確な、誤りのある
inadequate|不十分な、不適当な
inappropriate|ふさわしくない、不適当な
uncertain|はっきり分からない、(人が)確信がない
vague|あいまいな、不明確な
retreat|引っ込む、退く
revolt|暴動[反乱]を起こす、をむかむかさせる
deflect|(人の注意・非難など)をそらす、の方向を変えさせる
demote|を降格する
despise|を軽蔑する、をひどく嫌う
grasp|を理解する、をしっかりと握る
summon|を呼び出す、を召喚する、(議会など)を招集する
expel|を追放する；を吐き出す
redeem|(失敗・欠点など)を補う、を埋め合わせる
comprise|から成る；を構成する
prevail|普及している；支配的である；（～に）打ち勝つ（over）
eject|を取り出す、を追い出す
falsify|を偽造する
obstruct|をふさぐ、を妨害する
depict|を描く
tremble|震える
confess|（を）告白する
stare|じっと見つめる
ache|痛む、うずく
reflect|を反映する、を反射する、熟考する
assert|を主張する
impose|(規則・税・罰金など)を課[科]す、を押しつける
interpret|を解釈する、を通訳する
devote|(努力・時間など)を捧げる、に専念する
deteriorate|(状況・質など)が悪化する
contemplate|（を）熟考する；を予想する
delegate|(権限・責任など)を委譲[委任]する、(人)を代表として派遣する
propel|を進ませる、(人)を駆り立てる
recede|後退する、退く
scrape|(泥・ペンキ・さびなど)をこすり取る、の表面をこする
smash|を粉砕する；を強打する；粉々に壊れる；激突する
scold|(特に子供)をしかる
amuse|を楽しませる
overhaul|(システムなど)を総点検する、を分解修理する
herd|(牛・羊などの)群
bait|誘惑物、(釣り針・わなにつける)餌
petition|請願(書)、嘆願(書)
ransom|身代金、(身代金などによる)解放
fragrance|芳香
insight|見識、洞察力
conquest|征服、(欠点・課題などの)克服
sincerity|誠実
tariff|関税
sanction|制裁(措置)、認可
sphere|領域；球体；天体
outcast|見捨てられた人、浮浪者
affair|事情、事柄、問題
scandal|スキャンダル、不正行為
allergy|アレルギー
destruction|破壊、破滅
peasant|(発展途上国などの)小作人、貧農
burden|負担、重荷、荷物
faculty|(大学・学部の)教授陣、学部、才能、能力
tactics|作戦，方策；戦術，戦法
fare|(乗り物の)運賃、料金
manner|方法、風習、行儀、作法
correlation|相互[相関]関係
weed|雑草、草
command|命令、指図、(外国語などを)自由に使える能力
quarter|４分の１、(都市の特定の)地区、四半期
availability|(入手の)可能性、有用[有効]性
caution|用心、注意、警戒、警告
prevention|予防、防止、妨害
reptile|爬虫類(動物)
fate|運命、(最終的な)結末
inclination|意向、願望、好み
scorn|軽蔑、侮蔑
contempt|軽蔑；恥辱
domain|分野；領域；ドメイン
pillar|柱、支柱
tender|柔らかい、優しい
awkward|ばつの悪い、気まずい、ぎこちない
fierce|猛烈な；どう猛な
peculiar|変な、特有の
genuine|本物の
vigorous|精力的な；激しい；活力のある
gloomy|陰気な；薄暗い；悲観的な
medieval|中世の
subtle|微妙な、かすかな
rigid|厳しい；硬直した
coarse|粗い、粗野な
humble|謙虚な、地位[身分]などが低い
slack|たるんだ、(商売などが)不活発な
trivial|取るに足らない
mutual|相互の
redundant|不要な、余分な、(表現などが)冗長な
premature|早過ぎる、(判断などが)早まった
attentive|注意深い
integral|不可欠な、必要な
memorable|忘れられない、記憶すべき
persuasive|説得力のある
prevalent|蔓延している、広く行き渡っている
unaware|気づかないで、知らないで
worthwhile|(時間・労力・金をかける)価値のある
amazing|驚くべき
eligible|適格の，資格のある；（結婚相手として）望ましい
vicious|悪意[敵意]のある、乱暴な
invisible|見えない
invalid|(法的に)無効な
rotten|(食べ物などが)腐った、(道徳的に)腐敗した
plague|疫病；（害虫などの）異常発生
sponsor|に資金を提供する、を後援する
honor|を賞賛する、に与える、を尊敬する
remark|～と述べる
incorporate|を取り[組み]入れる
resolve|(問題など)を解決する、を決意する
sway|(ゆっくりと)揺れる、動揺する
inherit|(遺伝で)を受け継ぐ、を相続する
pile|を大量に積む、を積み重ねる、積み重なる
renovate|を改修[改築]する
maximize|を最大限にする
uncover|(遺跡など)を発掘する、の覆いを取る、を明るみに出す
mislead|に誤った考えを持たせる、を欺く
opt|選ぶ
outnumber|より数で勝る
presume|と思う；と推定する；を前提とする
refine|を洗練する；を精製する
stir|をかき回す；を揺り動かす
strive|懸命に努力する
thrill|をわくわく[ぞくぞく]させる
tighten|を固く締める、を強化する
arouse|（感情など）を引き起こす；を目覚めさせる
buzz|(場所が)ざわつく、どよめく
converge|集まる、集中する
deduct|を控除する、を減じる
disconnect|(人)のインターネットへの接続を切る、の接続を断つ
gossip|うわさ話をする
wander|(当てもなく)歩き回る、ぶらつく
suck|（を）吸う；（を）しゃぶる
dye|を～色に染める、を染める
trespass|(不法)侵入する、侵害する
graze|(家畜などが)牧草を食べる
entrust|AにBを任せる
peer|同僚、仲間、同等[対等]の者
molecule|分子、微粒子
meantime|その間
merit|価値、優秀さ、長所
prospect|見込み、見通し、期待
chatter|くだらないおしゃべり
funeral|葬式
methodology|方法論、研究方法
bundle|束、包み
burglar|強盗、泥棒
canyon|峡谷
duration|（時間の）継続，持続（時間）
fountain|噴水、源泉、湧き水
genius|天賦の才、天才(的な人)
grassland|牧草地、草原
interval|（時間の）間隔；合間；隔たり；小休止
longevity|長寿；寿命；長年勤続
mode|方法、様式
needle|針、縫い針、編み針
organizer|主催者、まとめ役、幹事
rehearsal|(劇・音楽などの)リハーサル、下げいこ
servant|(特に住み込みの)使用人、召使
sociology|社会学
spectacle|(印象的な)光景、壮観、見もの
norm|標準、規範、典型
certificate|証明書；免許状
vice|悪習、悪
knot|結び目、結び方
rubber|ゴム、ゴム製品
asteroid|小惑星
syndrome|症候群、シンドローム
detention|拘置、留置
distress|苦悩、苦痛
ignition|(エンジンの)点火装置、点火
esteem|尊敬、尊重
hospitality|親切なもてなし，歓待；受容性
legacy|遺産
sane|(考え方などが)健全な、分別のある、正気の
doubtful|(物・事が)疑わしい、(人が)疑わしく思う
favorable|好意的な、好ましい
generous|気前のよい、寛大な
hollow|空洞の；空虚な；うわべだけの
internal|内部の、内側の、国内の
interpersonal|人間[対人]関係の
staple|必需食品；主要産物
tolerant|寛容な、包容力のある
folk|民間(起源)の、民衆の
furious|激怒した；猛烈な
ironic|皮肉な、反語的な
pale|(人・顔色などが)青白い、血の気を失った、(色が)淡い、薄い
pregnant|妊娠した
rewarding|満足感が得られる、報われる
sacred|神聖な、聖なる、宗教的な
terrific|素晴らしい、すてきな
abridged|簡約[短縮]された
dull|退屈な、頭が鈍い
faint|かすかな；めまいがする；弱々しい
irresponsible|無責任な
notorious|悪名高い（≒infamous）
recurrent|(周期的に)繰り返される、(病気などが)再発する
irresistible|抵抗できない、非常に魅力的な
binding|拘束力のある、義務を負わせる
dejected|落胆した、元気のない
fictitious|架空の、偽りの
gracious|親切な、丁寧な
upcoming|やがて起ころう[現れよう]としている、来るべき
abundant|豊富な
grind|（穀物など）をひく
archive|〔しばしば～s〕記録文書，公文書；公文書保管所；（コンピューターの）アーカイブ
devise|を考案する
precede|に先行する
horrify|を怖がらせる
lodge|(苦情・抗議など)を申し出る、を預ける、を泊める
mediate|調停する、仲裁する
mingle|付き合う、仲間に入る、混ざる
perspire|汗をかく
concede|(しぶしぶ)～と認める
hinder|を妨げる
waver|(心が)揺れ動く、迷う
formulate|(計画など)を(注意深く)まとめる、を明確に述べる
exhale|(息・煙・言葉など)を吐き出す
rebound|(ボールなどが)跳ね返る
gratify|を喜ばせる、を満足させる
pledge|を誓う，約束する；を与えることを約束する
fasten|をしっかり留める、を固定する
relay|を伝達する、を取り次ぐ、を中継で送る
align|を一直線に並べる
ascend|（を）上がる
gaze|じっと見る
adore|が大好きである、を敬愛する
chill|(食べ物・飲み物など)を冷やす、冷える
curve|カーブする、曲がる
deflate|(タイヤ・風船などが)しぼむ、をしぼませる
detach|を分離する、を取り外す
enclose|を同封する；を取り囲む
fetch|を（行って）持って［連れて］くる
proclaim|を宣言する
forge|を偽造する；（関係など）を築く；を鍛造する
outburst|(火山・怒り・笑いなど)の爆発
dimension|局面、寸法、規模、次元
swarm|大群
sequel|続編、結果
artifact|人工遺物、工芸品
mercy|慈悲；〔通例a ～〕幸運
successor|後継者、相続人
triumph|(大)勝利、成功
clause|(法律・条約などの)条項、(文の)節
analogy|類推；類似
downfall|破滅、転落、(雨・雪などの)大降り
fusion|融合(物)、(政府などの)連立
fracture|骨折、割れ目、裂け目
menace|困りもの、危険人物、脅威
setback|(進歩・発展の)妨げ、支障
empathy|共感、感情移入
tumble|転倒、(株価などの)暴落
diameter|直径
momentum|勢い、はずみ
troop|軍隊、兵隊
pharmacy|薬屋、薬局
nightmare|悪夢、(悪夢のような)恐ろしい経験
slope|坂、斜面
glacier|氷河
grief|(死などに対する)深い悲しみ、悲痛
misery|惨めさ、悲惨さ
accent|なまり、方言
ambassador|大使
autopsy|検死
blast|爆発、爆破、突風
courtesy|礼儀正しさ；好意；優遇
deed|(意図的な)行為、行い
discourse|話し合い，会話；講演；論説
impulse|衝動
jar|(広口の)びん、つぼ
sibling|兄弟姉妹(の１人)
enthusiasm|熱狂、熱中
treasure|宝物、貴重品
horizontal|水平な
indefinite|限定されない、不定の、はっきりしない
vulgar|下品な、無作法な
resilient|回復力のある、弾力(性)ある
aquatic|(動植物が)水生の、水の
insistent|強く主張する、執拗な
frantic|大急ぎの、気が狂いそうな
deceptive|人を惑わすような
illogical|筋の通らない、不合理な
elaborate|精巧な、入念な
mellow|(性格が)円熟した、柔らかくて豊かな[美しい]
boundless|無限の
cordial|心温まる、心からの
seasonal|季節(ごと)の
sour|酸っぱい
swift|素早い
cumulative|累積する、しだいに増加する
savage|残酷な、凶暴な
admirable|賞賛に値する、素晴らしい
informative|有益な、情報[知識]を提供する
proportional|釣り合った、比例した
simultaneous|同時に起こる
static|変化[進歩]のない
uneasy|不安な、心配な、落ち着かない
unequal|(権利などが)不平等な
autonomous|自治の、自主的な
bold|大胆な、勇敢な
pessimistic|悲観的な
repetitive|繰り返しの
respiratory|呼吸器に関する、呼吸の
coherent|一貫した，筋の通った；結束した
account for ～|(割合・分量など)を占める、～(の理由)を説明する
accuse A of B|AをBの罪で告訴する、AをBの理由で非難する
act on ～|(忠告・情報など)に従って行動する、～に影響を及ぼす
act out ～|(物語・経験など)を身振りで実演する
add up to ～|(合計が)～になる、結局～ということになる
adhere to ～|(信念・規則など)を順守する、～に固執する
air out ～|(部屋など)を換気する、(衣類・寝具など)を外気に当てる
all but|ほとんど
allow for ～|～を考慮に入れる、～を見込む
answer for ～|～の責任を負う、～の罰を受ける
aspire to do ～|～することを熱望[切望]する
attribute A to B|AをBのせいと考える
back down|撤回する、敗北[非]を認める
back off|手を引く、撤回する、後退する
back up ～|～を裏付ける、～を支援する、(ファイルなど)のコピーを取る
back on ～|～を当てにする
be committed to ～|～に献身している
be destined to do ～|～する運命である
(be) free of ～|(料金・税金など)がない、～免除されている
be obsessed with ～|(妄想・固定観念など)に取りつかれている
be subject to ～|(病気など)にかかりやすい、(影響など)を受けやすい
blast off|打ち上げられる、発射される
blow up|(かんかんに)怒る、爆発する
bounce back|(打撃・病気などから)回復する、立ち直る
branch off|(話題が)変わる、(わき道に)それる
break away from ～|(伝統・習慣など)を断つ、(束縛など)から逃れる
break down|決裂する、失敗する、故障する
break off ～|～を中断する、～を急にやめる
break out|勃発する、(伝染病などが)発生する
bring about ～|～を引き起こす、～を招く
bring down ～|(人・政府など)を(打ち)倒す
bring off ～|～をやってのける、～を成し遂げる
bring on ～|(災い・病気など)をもたらす
bring out ～|(才能・性質など)を引き出す、～を発揮させる
bump into ～|～にばったり出会う
burn out ～|(人)を疲れ果てさせる、～を燃え尽きさせる
by means of ～|～用いて、～によって
call for ～|～を必要とする、～を要求する
call off ～|～を中止する
call on ～|～を訪ねる、(人)に頼む
carry away ～|無我夢中になる、～を持ち去る
carry through ～|～を成し遂げる、～を成就させる
catch up on ～|(近況など)について新しい情報を知る、～の遅れを取り戻す
check off ～|～にチェックマークをつける
chip in ～|(金・労力などを)出し合う
clean out ～|～の中をきれいにする、～を空にする
clear out ～|～の中身を出してきれいに片付ける、～を空にする
clear up (～)|(誤解など)を解く、(問題など)を解明する、～片付ける、晴れる
close in (on ～)|(～を)包囲する、(～に)追ってくる
come after ～|～の後をつける、～を追跡する
come before ～|(問題などが)(法廷など)で審議される、(法廷など)に出頭する
come down to ～|要するに～ということになる
come down with ～|(軽い病気)にかかる
come into ～|～の状態になる
come off|結局～になる、行われる
come through|要求に応える、伝えられる
comply with ～|(規則・基準など)に従う
contribute to ～|～の一因となる、～に寄与[貢献]する～に寄付する
cope with ～|～うまく処理する、～に対処する
count for ～|～の価値がある
count on ～|～を当てにする
cover for ～|～の代わり[代理]を務める
cover up ～|～(の事実)を隠す、～を秘密にする
crack up|神経が参る、気が変になる、大笑いする
cross out ～|～を線を引いて消す
cut back (on ～)|(～を)削減[縮小]する
cut down (on ～)|(～を)減らす
cut in (on ～)|(話などに)割り込む、さえぎる
deal in ～|(商品)を商う、(仕事など)に従事する
deprive A of B|AからBを奪う
die down|静まる、衰える
die out|絶滅する
dispose of ～|～を処分する、を捨てる
do away with ～|～を廃止する、～を取り除く
drag on|(会議などがだらだらと)長引く
drag out ～|～を(必要以上に)長引かせる
draw on ～|(技術・経験など)に頼る、～を利用する
draw up ～|(計画)を立てる、(報告書など)を作成する
dream up ～|(奇抜な考え・計画など)を思いつく、～を考え出す
drive off [away] ～|～を追い払う
drive up ～|(価格など)を急速に上昇させる
drop back (to ～)|(～に)後退する、順位が下がる
drop out (of ～)|(活動・集団から)身を引く、(学校を)中途退学する
ease into ～|(仕事など)に徐々に慣れる
eat up ～|～を使い果たす、～を食べ尽くす
embark on [upon] ～|(事業など)に乗り出す、～に着手する
endear A to B|AをBに慕わせる
even up ～|～を等しくする、～を均等にする
face off|対決する
fall away|減少する、弱まる、衰える
fall back on ～|～を当てにする
fall for ～|(うまい話・売り込みなど)に乗せられる、～に強く引きつけられる
fall off|(数・量が)減少する、(質が)低下する
fall on ～|(責任・仕事などが)～に降りかかる、(記念日などが)～に当たる
fall through|(計画などが)駄目になる、失敗する
fall under ～|(影響・監督など)を受ける
feel for ～|～に同情する、～を思いやる
figure out ～|～を理解する、～を解決する
fill out ～|(書類)に必要事項を記入する
fire up ～|～始動させる、～に火をつける
fit into ～|～に溶け込む、～に収まる
fix up ～|～を修理する、～を改装する
for all ～|～にもかかわらず、～を考慮しても
for the time being|当分の間(は)、さしあたり
force down ～|(感情など)を抑える
free up ～|～を自由化する、～解放する
frown on [upon] ～|～に難色を示す、～に不賛成の意を表す
gear up ～|準備をする
get around (～)|あちこち動き回る、歩き回る、～をうまく避ける、～を逃れる
get around to doing ～|～をする余裕[暇]ができる
get away with ～|～を(罰などを受けずに)うまくやる
get by ～|何とかやっていく、通り抜ける
get down to ～|～本気で取りかかる
get in on ～|～に参加する、～に加わる
get into ～|(本・映画・音楽など)に夢中になる、(ある状態)になる
get on with ～|(仕事など)を続ける、(人)とうまくやっていく
give away ～|(秘密・答えなど)をばらす、～をただで与える、～を安く売る
give in (to ～)|(～に)降参する、屈する、負ける
give off ～|(光・音・においなど)を発する
give A over to B|AをBに預ける、AをBに引き渡す
give rise to ～|～の原因となる、(悪い事態)を生じさせる
go back on ～|(約束など)を破る
go for ～|～を選ぶ
grow into ～|(成長して)(服など)を着られるようになる
grow on ～|(人)の気にいるようになる、(習慣などが)～の身につてくる
grow out of ～|(成長して)(行為・習慣など)から脱する、～から生じる
hand down ～|(伝統・慣習など)を(後世に)伝える、(判決など)を言い渡す
hand off ～|～を任せる、～を引き渡す
hand out A (to B)|(Bに)Aを配る
hang around (～)|(～を)ぶらつく、うろつく
hang on|(少し)待つ、電話を切らずにおく
hang up ～|(電話を)切る
head off (～)|～を阻止する、～を回避する、出かける、立ち去る
head out|出かける、立ち去る
hold back ～|～を抑えておく
hold off ～|～を引き延ばす、～を延期する
hold out (～)|(敵・逆境・圧力などに)もちこたえる、～を差し出す
hold over ～|続映[続演]される、～を延期する
in a row|連続で
in favor of ～|～に賛成して、～を支持して
in response to ～|～に応えて、～に応じて
in terms of ～|～の観点から
in the event of ～|(万一)～の場合には
in vain|無駄に、効果なく、～にすぐ飛びつく
jump at ～|～にすぐ飛びつく
keep track of ～|(人の動向・情勢など)に注意している、～の跡をたどる
keep up with ～|(時勢・流行・人・仕事・勉強など)に遅れずについていく
kick around ～|(計画・提案など)をあれこれ検討する
kick in|(薬などが)効き始める、機能し始める
kick off A (with B)|(Bで)Aを開始する
kick A out (of B)|(Bから)Aを追い出す[首にする]
knock down ～|～を取り壊す、～を解体する、～を殴り倒す
lay into ～|～を厳しく非難する、～を攻撃する
lay off ～|(一時的にまたは永久に) ～を解雇する
leave off (～)|(～を)やめる
let alone ～|まして～、～は言うまでもなく
let down ～|～を失望させる、～(の期待・信頼)を裏切る
let out ～|(声など)を出す、(感情)を表す、～を外に出す
let up|手を緩める、(望ましくないことが)弱まる、(風雨などが)やむ
level off [out]|横ばいになる、安定する
lift off|(飛行機などが)離陸する
live up to ～|(期待など)に応える、(規範など)に従って行動する
lock in ～|～を固定する、(鍵をかけて)～を閉じ込める
look down on ～|～を見下す、～を軽蔑する
make (both) ends meet|(収支を合わせて)収入内で何とかやりくりする
make do with ～|(あり合わせのもの)で済ます
make it|間に合う、成功する、(会合などに)出席できる
make out (～)|～を理解する、うまくやる
make over ～|～を作り変える、～変身させる
mark down ～|～を値下げする、～を書き留める
mark out ～|(線などで)～を区画する、～を区切る
miss out on ～|(機会・好機など)を逸する
narrow down ～|(範囲など)を制限する、～を狭くする
on a ～ basis|～の基準で、～の原則で
on [in] behalf of A|Aを代表して、Aに代わって
on the contrary|それどころか、まるで反対で
on the spot|その場で、即座に
on the verge of ～|～の間際[寸前]で
over the hump|難局を脱して、峠を越して
owing to ～|～のために、～の理由で
pack up|(仕事などが終わって)持ち物をまとめる、荷造りする
pass for ～|～で通る、～と見なされる
pass off A (as B)|Aを(Bだと)偽る
pass A on (to B)|A(もの・情報・病気・利益など)を(Bに)伝える[渡す]
pass out|気絶する
pay off ～|(借金など)を全部支払う
phase out ～|～を段階的に廃止[排除]する
pick over ～|～念入りに調べて選ぶ、～を吟味する
pick through ～|～の中をくまなく探す
pile up|(仕事・借金などが)どんどんたまる、山積する
pin down ～|～を押さえつける、～を動けなくする
play down ～|～を(実際より)重要でないように見せようとする
play out (～)|(物事・状況が)展開する、徐々に進展する、～を最後まで演じる
play up ～|～を誇張する、～強調する
point to ～|(状況・証拠などが)～を示す、(大事な点・理由など)を指摘する
pull back (～)|後退する、～を後退させる、思いとどまる
pull in ～|(観客・客など)を引きつける、(利益・金など)を得る
pull off ～|(困難なこと)をやってのける
pull through ～|(病気・苦境など)を切り抜ける
push for ～|～を要求する、～を得ようと努める
push through ～|(議案など)を通す、～を突き進む
put down ～|(金額)を手付金として払う、～を書き留める
put forth ～|(力など)を発揮する、(計画・案など)を提出する
put toward ～|～を提案[提出]する
put in ～|(設備など)を備え付ける、(金・時間・精力など)をつぎ込む
put A through (to B)|Aの電話を(Bに)つなぐ
read off ～|(リストなど)を読み上げる
refrain from doing ～|～するのを控える、～するのをやめる
regardless of ～|～に(も)かかわらず、～にかまわず
roll in (～)|(金など)がたくさんある、転がり込む、どっと集まる
roll up ～|～をくるくると巻く、(そで・すそ)をまくり上げる
round off ～|～を締めくくる、～をうまく終える
round up ～|(散らばった人など)を集める、～を逮捕する
rule out ～|～を排除する、～を除外する
run against ～|～に不利になる
run down ～|(車・運転手が)～をひく、～のことを悪く言う、～を突き止める
run through ～|ざっと～を読み上げる[に目を通す]
scoop up ～|～を抱き上げる、～をすくい上げる
scratch out ～|～を削除する、やっと(生計)を立てる
see about ～|～を検討する、～を手配する、～を何とかする
see A off|(空港・駅などで)Aを見送る
see through ～|～を見抜く、～を見破る、～を通して見る
sell out|(期待を)裏切る、(ものが)売り切れる
send for ～|(人・助けなど)を呼ぶ、～に来てもらう
send out for ～|(食べ物)の出前を頼む
set aside ～|(時間・金など)をとっておく、～をわきへどける
set down ～|～を書き留める
set in|(季節・流行・好ましくないものなどが)始まる、起こる
set off (～)|出発する、～を引き起こす、～を作動させる
set out to do ～|～することに着手する、～し始める
set up ～|(会合など)を準備する、～を設置する、(会社・組織など)を作る
settle down|ゆったりとくつろぐ、落ち着く、定住する
settle up (with ～)|(～と)精算する、(～に)勘定を支払う
shake up ～|～を刷新する、～を動揺させる、～を奮い立たせる
show off (～)|いいところを見せる、～を見せびらかす
show up|現れる、やってくる
sign up for ～|(署名して)～に参加する、(受講など)の届けを出す
single out ～|～を(特に)選び出す
sink in|十分に理解される、分かってもらう
sit back|何もしないで[手をこまねいて]いる、くつろぐ、(いすに)深く座る
sit by|(悪い事態を)黙って見ている、傍観する
sit in|参加する、見学[参観]する、代理を務める
skim over ～|～をざっと見る、～表面的に扱う
slip by|(時・機会が)いつの間にか過ぎる
smooth over ～|(話し合いをして)(問題・困難など)を処理しやすくする
speak for ～|～を代表して意見を述べる、～を代弁する、～への支持を表明する
split up (～)|別れる、分裂する、～を分裂させる
spring from ～|～から生じる、(人が)～の出である
spring up|急に生まれる、急成長する
stand down (as ～)|(公職など)を辞任する
stand for ～|～の略である、～を意味する、～を支持する
stand up to ～|～に抵抗する、～に立ち向かう、～に耐える
stay off ～|(健康のため)～を控える、～に近づかない
step down [aside]|辞任する
stick around|そこらで待つ、帰らずにいる
stick to [by] ～|(主義など)を堅持する、～をやり続ける
stick up for ～|～をあくまでも擁護する、～を支持する
stick with ～|～を最後までやり抜く、～を続けてする
stir in ～|～を入れてかき混ぜる
stir up ～|(騒ぎなど)を引き起こす、(想像力・記憶など)をかき立てる
sum up ～|～を要約する
take in ～|～を摂取する、(光景など)を観察する、～をだます、～を理解する
tale on ～|(特にきつい仕事・責任)を引き受ける
take over ～|～を引き継ぐ、～を買収する、～を占領する
take up ～|～を趣味[職業・学問]として始める、(問題など)を取り上げる
talk down to A|Aを見下した調子で話す
talk A into doing ～|Aを説得して～させる
talk up ～|(人・もの)を実際以上に興味深いもののように話す
tear down ～|～を取り壊す、～を解体する、～を殴り倒す
tell on ～|(特に子供が)～のことを告げ口する、～にこたえる
the other way around|(方角・事情などが)逆に[で]
throw off ～|(衣服など)をさっと脱ぐ[脱ぎ捨てる]、～を払いのける
throw up (～)|嘔吐する、(食べ物)を吐く
tidy up ～|(部屋・家・机など)を片付ける、～を整理する
tie up ～|忙しくて身動きできない、～を固く縛る
tip over (～)|ひっくり返る、倒れる、～をひっくり返す
touch up ～|(絵・文章・化粧など)を手直しする、～を修正する
track down ～|～を追跡して捕らえる、～を追い詰める
trip up (A)|Aをつまずかせる、つまずく、しくじる
try out ～|～を試してみる、～の効果を試す
tune in (to ～)|(局・番組などに)テレビ[ラジオ]のチャンネルを合わせる
tune up (～)|(楽器)を調律する、(エンジン・機械など)を整備する、調律する
turn around (～)|(商売・経済など)を好転させる、～の向きを変える、好転する
turn away ～|～を追い払う、(客など)の入場を断る、～を背ける
turn in (～)|～を提出する、寝る
turn out|であることがわかる、集まる
turn to ～|～に頼る、(犯罪・悪習など)に走る、～に取りかかる
walk off [away] with ～|～を盗む、(賞など)をあっさり手に入れる
wander off|はぐれる、(道路・場所から)外れる、(主題から)脱線する
want for ～|～を欠いている
wash away ～|～を洗い流す、(記憶・感情など)を洗い去る
wash down ～|(食べ物など)を流し込む、～を洗い流す
watch over ～|～の世話をする、～を見守る、～を監視する
wear off|(薬効・印象・痛みなどが)しだいに弱まる、すり減ってなくなる
wear out ～|～を疲れ果てさせる
weigh on ～|～に重くのしかかる、～を圧迫する、～を苦しめる
win over ～|～を説得する
wipe out ～|～を消滅[絶滅]させる、～を撲滅する
work out ～|(計画・対策など)を練る、(問題)を解決する、～を計算する
wrap up ～|(仕事・交渉など)を滞りなく終える