ブレーンストーミング|4つの原則を守りながら、新しいアイディアを引き出すことを目的に行われる話し合いの技法。|["脳内嵐","アイデア出し","知恵出し","集団発想法","思考技法"]
KJ法|問題点を明確にするために、情報収集→カード･グループ化→図解化→文章化の手順で行われるデータの整理方法。|["川喜田分析","図解化手法","カード整理法","データ関連付け法","アイデア整理法"]
決定表(デシジョンテーブル)|問題を解決するために、複数の条件とその条件に対応する行動を表形式に示した図。|["判断表","条件付きルール表","条件分岐表","処理選択表","実行選択表"]
DFD|4つの記号(1組の平行線、矢印、円、四角形)を用いて、データの流れと処理の関係を表す図。|["データ流図","データ移動図","データ遷移図","情報フロー図","業務フロー図"]
パート図(PERT）|アローダイアグラムともいい、プロジェクトの日程計画や日程管理に用いられ、相互関係にある作業を矢印でつないだ図。|["プロジェクト評価手法図","作業構造図","作業関連図","資源関連図","全体最適化図"]
クリティカルパス|パート図(PERT)において、作業の開始から終了までの所要日数が最長となる経路。この経路の一部に遅れが生じると、作業全体のスケジュールに影響する。|["重要経路","最重要経路","最低限経路","重大経路","必須経路"]
ABC分析|パレート図を使用して、各項目を重要な順に3つのグループに分けて、在庫管理などで分析する方法。|["選別管理法","重要度管理法","分類管理法","優先順位付け管理法","パレート法"]
パレート図|ABC分析のときに用いられるこどが多いグラフで、データを降順に並べた棒グラフと、その累計比率を表す折れ線グラフからなるグラフ。|["80対20の法則図","重要少数派分析図","偏在図","不平等図","分布状況図"]
Zグラフ|移動合計値(過去1年間分の売上累計)という特徴があるデータを用いて、一定期間の売上高の傾向を分析するときに用いるグラフ。|["Zスコア分析グラフ","移動範囲分析グラフ","移動量分析グラフ","偏差値グラフ","標準化グラフ"]
回帰分析|相関関係にある2つのデータ間の関係や傾向を分析して、結果を予測すること。|["関連分析","傾向分析","相関判定","因果関係分析","データ当てはめ"]
散布図|2つの項目の間の相関関係の有無などを示す図表。|["相関図","関係図","広がり図","ばらつき図","データマッピング"]
正の相関|2つの項目の間で、1つが増加すると、もう1つも増加する関係で、散布図においては、点のばらつき具合が右上がりの状態。|["正の依存","増加相関","右上がり関連","同方向関連","直線関係"]
負の相関|2つの項目の間で、1つが増加すると、もう1つが減少する関係で、散布図においては、点のばらつき具合が右下がりの状態。|["減少相関","逆相関","右下がり関連","反対方向関連","逆方向依存"]
回帰直線(近似曲線）|散布図において、ばらつきのあるデータの関係を導くために、誤差が最小になる直線。|["適合直線","相関直線","近似曲線","回帰曲線","当てはめ直線"]
線形計画法|費用を最小限に抑えて最大の利益を得るための生産計画など、複数の制約条件の中で、最大(最小)値を求める手法のこと。|["線形プログラミング","数理計画法","数理最適化","線形制約最適化","数学的最適化"]
ヒストグラム|データ範囲をいくつかの区間に分け、各区間に入るデータの数を柱状で表したグラフ。|["分布表","度数表","棒グラフ表","チャート表","度数グラフ"]
管理図|中央線と上下一対の限界線を引いて、製品などの特性値をプロットし、品質不良や製造工程の異常を検出して不良原因の除去や再発防止に役立てる。|["統計的処理管理図","分布管理図","モニタリング図","変動図","統計図"]
特性要因図|結果とそれに影響を及ぼしたと思われる原因の関係を体系的に表した図。直接的な原因と間接的な原因に分別して、真の問題点を明確にする効果がある。|["原因結果図","イシュカワ図","関係図","影響図","フィッシュボーン図"]
ファンチャート|ある時点のデータを基準に、その後のデータの変動を比率で表す折れ線グラフのこと。|["指標変化図","指標伸び図","指数化グラフ","伸び率グラフ","変動率グラフ"]
SWOT分析|自社の現状を、強み･弱み･機会･脅威の4つの要素に整理して、市場環境を分析すること。|["環境分析","状況分析","戦略分析","要因分析","課題抽出"]
PPM分析|事業管理手法の一つで、自社の製品またはサービスを、市場の成長率と市場の占有率から、金のなる木･花形･問題児･負け犬の4つの区分に分類して、事業展開を決定するための手法。|["製品投資分析","製品マトリックス分析","事業選択分析","製品戦略分析","事業方針決定"]
コンプライアンス|｢法令遵守｣といわれるが、企業が法律や条例を守るだけではなく、企業倫理や社会貢献などを含めて自発的に取り組んでいくこと。|["法規制遵守","社会規範遵守","ルール遵守","義務遵守","倫理遵守"]
セキュリティーポリシー|企業や団体などの組織における情報セキュリティに関する基本的な方針であり、アクセス権限や保護対象範囲の設定などを具体的にまとめたもの。|["安全方針","保護方針","守秘方針","機密方針","リスク回避方針"]
ERP(経営資源計画)|企業の持つ人材、資金、設備、情報など様々な経営資源を一元的に管理、有効活用し、業務の効率化を図るための経営全体の最適化を目指す手法。|["経営管理システム","業務システム","資源最適化","業務効率化","情報システム"]
CRM(顧客関係管理)|企業のすべての部門と顧客との間に信頼関係を築いて、企業と顧客の利益を共に向上することを目指す経営手法。|["顧客サポート","顧客満足","顧客忠誠心向上","顧客との信頼関係構築","顧客データ分析"]
BPR(業務プロセス再設計)|企業活動に関する売り上げなどの目標を設定して、目標達成のための業務内容、流れ、組織を分析し、最適化や再構築すること。|["業務改善","プロセス改善","業務効率化","改善活動","業務イノベーション"]
アウトソーシング|コスト削減などのために自社の業務や機能の一部または全部を、それを専門とする外部の専門業者に委託すること。|["外注","業務委託","作業移管","プロセス移管","サービス利用"]
アライアンス|複数の企業が互いに経済的なメリットを期待するために、企業が連携して協力体制を構築すること。|["協業","共同事業","連携","協定","協力関係"]
ハウジングサービス|顧客のサーバ自体を、ネットワーク環境の整った場所に設置するサービス。|["設備管理サービス","スペース貸し","収容サービス","設備貸与","データセンター"]
ホスティングサービス|情報通信ネットワークを利用して、自社のサーバを貸し出すサービス。|["サーバ管理サービス","サーバ提供","サーバ貸与","サーバ運用","データセンター"]
排他制御|データベースにおいて、あるデータを処理しているとき、他からの更新や書き込みなどを制限することによって、データの整合性を保つしくみ。|["競合排除","競合防止","同時実行防止","シリアライゼーション","デッドロック防止"]
ロック|同じデータに、複数のアクセスをする場合の整合性を取るための工夫。|["占有制御","更新制限","参照制限","変更制限","更新排他"]
共有ロック|データベースにおいて、ファイルを保持するために、ファイルを読み込むことは可能だが、レコードのデータの変更はできないこと。|["読み取りロック","参照ロック","共有参照","参照可能","変更不可"]
占有ロック|一つのレコードに対して一つの参照･変更･削除だけが取得できる。データを更新している途中で、他がデータを読み込んだり、変更できないようになる。|["書き込みロック","更新ロック","占有制御","変更可能","参照不可"]
デッドロック|排他制御を行った複数の処理が互いにロックをかけることで、相手のロック解除待ち状態が発生してしまい先に進まなくなる状態。|["相互待ち","循環待ち","資源待ち競合","処理待ち合い","オーバーロック"]
トランザクション|データベースにおいて、一連の更新処理のこと。|["処理単位","一連の処理","データ更新単位","データ操作単位","処理の集合"]
コミット|データベースにおいて、更新処理などがすべて正常に完結したという宣言。|["確定処理","反映処理","登録処理","適用処理","成功報告"]
ジャーナルファイル|データベースの更新前と更新後のデータの状態を記録したファイル。|["処理記録","トランザクションログ","更新ログ","操作ログ","トレース情報"]
チェックポイント|メモリ上のデータをディスクに書き込むタイミングのこと。障害発生の際、復旧作業に利用されることもある。|["保存タイミング","スナップショット","中間データ","復元地点","段階保存"]
ロールバック|データベースにおける更新処理の途中などで、何らかの理由で不都合があった場合、データの整合性を保つために、ジャーナルファイルを用いてトランザクション処理開始時点の状態に戻すこと。|["元に戻す","巻き戻し","状態回復","変更取消","更新前状態回復"]
ロールフォワード|データが保存されているハードディスクに障害が発生した場合、バックアップファイルとジャーナルファイルを用いて、ハードディスクの障害発生直前の状態に復元すること。|["再実行","更新再適用","差分反映","最新状態へ復元","操作再実施"]
概念設計|データベース設計の初期段階で、業務内容を分析して必要なデータや管理方法を検討する作業。|["概念図","概念図化","概念データモデル","概要設計","マスタ設計"]
論理設計|概念設計の結果をシステム化の対象範囲に限定して定義すること。実際の業務での画面や帳票を参考にして、システムで必要とするデータを洗い出す。|["詳細設計","論理データモデル","論理図","テーブル定義","データ関係定義"]
物理設計|論理設計の結果を用いて、処理内容などの観点から、ハードウェアの選択や、最適配置などの検討を行うこと。主キーやインデックスの設定、必要容量の算定も行う。|["実装設計","物理データモデル","テーブル配置","基本図","内部計画"]
非正規形|データの不整合や冗長性があり、DBMSへの負担がかかる表の構造。|["混乱"," 複雑"," 乱雑"," 混迷"," 矛盾"," 複合"]
第1正規化(正規形)|非正規形から、重複して繰り返し現れる項目を排除すること。|["第2正規化(正規形)"," 第3正規化(正規形)"," 第4正規化(正規形)"," 第1非正規化(非正規形)"," 第3非正規化(非正規形)"]
第2正規化(正規形)|第1正規化から、主キーと関連のある項目を別のテーブルに分割すること。|["第3正規化(正規形)"," 第4正規化(正規形)"," 第2非正規化(非正規形)"," 第3非正規化(非正規形)"]
第3正規化(正規形)|第2正規形から、主キーでない項目について、関連のある項目を別のテーブルに分割すること。|["第1正規化(正規形)"," 第4正規化(正規形)"," 第3非正規化(非正規形)"," 第1非正規化(非正規形)"]
E-R図|データベース設計において、データの関連性をモデル化するために、｢実体｣、｢属性｣、｢関係｣の3つの図形を用いて表す図。|["実体関連図"," エンティティリレーション図"," データモデル"," スキーマ図"," レーショナルモデル"," データフロー図"]
エンティティ|一単位として扱われるデータのまとまりや、データベースとして表現すべき対象物のこと。論理設計の段階では、表に相当する。|["オブジェクト"," サブジェクト"," 実体"," 事象"," モデル"," インスタンス"]
アトリビュート|エンティティが持つ特性、特徴などの値。|["特性"," 属性"," 特徴"," 要素"," 資質"," 個性"]
リレーションシップ|エンティティとエンティティの相互関係。|["関係"," つながり"," 連携"," 結びつき"," 交流"," シンクロ"]
整合性制約(参照整合性)|レコードの追加や削除が勝手に行われないように、データベースの参照関係の整合性に関する規則。|["統一性制約"," 規範制約"," 一貫性制約"," 調和制約"," 調整制約"," 調和性制約"]
副問合せ|ある表に対して問い合わせを行い、その結果を利用してさらに、次の問い合わせを行うときの最初の問い合わせ。|["サブクエリ"," 補助問い合わせ"," 補完問い合わせ"," 付加問い合わせ"," 補助クエリ"," 補完クエリ"]