キャッシュメモリ|CPUと主記憶装置との間に置いて、データを高速転送するために一時的に用いる記憶装置。|["キャッシュ記憶","記憶キャッシュ","記録トレイ"]
ディスクキャッシュ|ハードディスクなど低速な記憶装置からデータを読み込むとき、データを一時的にメモリに格納しておくことにより処理を高速化するしくみ。|["ディスク記憶","記憶ディスク","ディスクトレー","トレーディスク","ディスク記録","記録ディスク"]
プラグアンドプレイ|コンピュータに新しいハードウェアを追記するときなど、必要な設定をユーザが手動で設定作業をしなくても、OSが自動的に最適な設定を行うシステム。|["プラグインスタール","インストールプラグ","プラグオアプレイ","起動プラグ"]
SSD|HDD(ハードディスクドライブ)に比べて、軽量小型で読み書き速度も速い、半導体メモリを使用した記憶装置|["HSD","メモリ","CDD","COD","DSD"]
ウォーターフォールモデル|比較的大規模な開発に向いており、基本設計、外部設計などいくつかの工程に分割してシステムを開発する手法。原則として前の工程には戻らない。|["ウォーターアップモデル","ウォータサーバモデル","ウォーターサーバーモデル","ウォーターネームモデル"]
プロトタイピングモデル|試作品に対するユーザの評価をもとに、システムを開発する手法。|["試作品モデル","モデル試作品","試作開発","開発試作","試作方式","方式試作"]
スパイラルモデル|システムを独立性の高い部分ごとに分割し、ユーザの要求やインタフェースの検討などを経て、設計･プログラミング･テストの工程を繰り返してシステムを開発する手法。|["螺旋モデル","モデル螺旋","螺旋開発","開発螺旋","螺旋方式","方式螺旋"]
基本設計|ユーザと開発者が十分話し合い、ユーザからの要件をシステムに反映できるかを判断して、システムへの要求機能を決定する開発工程。|["根幹設計","設計根幹","基礎設計","設計基礎","基本計画","計画基本"]
外部設計|システム開発において、画面や帳票などを利用者側の視点から設計するシステム開発工程。|["顧客設計","設計顧客","外観設計","設計外観","外部計画","計画外部"]
内部設計|ソフトウェアのアルゴリズムや入出力データなどを詳細に設計するシステム開発工程。|["内観設計","設計内観","内装設計","設計内装","内部計画","計画内部"]
プログラム設計|内部設計に基づいて、各プログラムの内部構造を設計する開発工程。|["コード設計","設計コード","プログラム計画","計画プログラム","設計コーディング","コーディング設計"]
プログラミング|プログラム設計の結果を受けて、プログラム言語を用いて実際にプログラムを作成(コーディング)する開発工程。|["コーディング","コード化","プログラム作成","作成プログラム","プログラム製作","製作プログラム"]
テスト|開発者だけでなくユーザも参加して、完成されたプログラムの検証を行うこと。|["検証","確認","評価","チェック","試運転","運転試験"]
単体テスト|個々のプログラム(部品）が、仕様書の要求どおりに機能しているかを確認するテスト。|["個別試験","試験個別","単独テスト","テスト単独","部品テスト","テスト部品"]
結合テスト|複数のモジュール(部品)を組み合わせて、モジュール間でデータの受け渡しが設計どおりに行われているかなどを確認するテスト。|["連結試験","試験連結","統合テスト","テスト統合","モジュールテスト","テストモジュール"]
システムテスト|開発したシステム全体が、設計どおりの機能を備えているかを確認するテスト。|["包括試験","試験包括","全体テスト","テスト全体","完成テスト","テスト完成"]
保守・管理|開発したシステムで、実際の業務中で生じた問題点を修正する作業、システムを効率的に稼働させるための業務。|["メンテナンス","運用","維持","運営","管理運転","運転管理"]
ブラックボックステスト|プログラムが仕様を満たしているかを確認するために、プログラムの内部構造には着目しないで、データ入力に対する出力結果に注目するテスト。|["出力試験","試験出力","非開示テスト","テスト非開示","ブラックテスト","テストブラック"]
ホワイトボックステスト|プログラムの内部構造や処理の流れに着目し、プログラムが設計通りに動いているかを確認するテスト。|["構造試験","試験構造","開示テスト","テスト開示","ホワイトテスト","テストホワイト"]
RASIS|コンピュータシステムに関する評価指標で、信頼性、可用性、保守性、完全性(保全性)、安全性(機密性)の５項目の英文字の頭文字を組み合わせた用語。|["ROSER","RARID","LAWSA","SKHKA","LOSER"]
信頼性|システムの故障発生が少ないこと。|["安定性","堅牢性","頑健性","故障回避性","耐障害性"]
可用性|一定期間にシステムが正常に使える時間の割合が長いこと。|["稼働率","利用率","アクセス容易性","参照容易性","応答性"]
保守性|故障の際の修復時間が短いこと。|["修繕性","保全性","管理性","点検性","整備性"]
完全性(保全性)|データの矛盾が起きないように、その整合性を維持すること。|["正当性","適正性","整合性","一貫性","誤り回避性"]
安全性(機密性)|不正に情報を持ち出したりすることから守ること。|["秘匿性","非公開性","セキュリティ","防護性","アクセス制限性"]
稼働率|コンピュータシステムが、一定時間内で正常に動作している時間の割合(確率)。|["稼働確率","動作確率","可用時間率","稼働時間率","アップタイム"]
平均故障間隔(MTBF)|コンピュータシステムが故障してから復旧し、次に故障するまでの平均時間。|["平均故障回数","故障発生周期","故障間欠時間","故障回避期間","信頼性指標"]
平均修復時間(MTTR)|コンピュータシステムが故障してから、完全に復旧するまでの平均時間。|["平均修理時間","平均回復時間","復旧期間","修理期間","保守性指標"]
スループット|コンピュータシステムや通信回線などが、一定の時間内に処理できる仕事量や伝送できる情報量。|["処理量","処理能力","実行量","作業量","生産量"]
レスポンスタイム|コンピュータシステムに処理を要求してから、最初の応答が得られるまでの時間。|["応答時間","応答速度","反応速度","待ち時間","遅延時間"]
ターンアラウンドタイム|コンピュータに処理実行の指示をしてから、すべての実行結果が得られるまでの時間。|["終了所要時間","総所要時間","ラウンドトリップ時間","往復時間","偏在時間"]
フォールトトレラント|障害が発生しても、システム全体が機能を停止することなく稼働し続けられるようにするしくみ。|["フォールトアボイダンス","フェールサーブ","フェールソフト","フォールトアボイダンス","フールプルーフ"]
フォールトアボイダンス|信頼性の高い部品の採用や利用者の教育など、コンピュータシステムに可能な限り故障や障害が起きないようにすること。|["フォールトトレラント","フェールサーブ","フェールソフト","フォールトアボイダンス","フールプルーフ"]
フェールセーフ|障害が発生しても、被害や障害を最小限に止め、安全性を保つしくみ。|["安全保持","フェールサーブ","フェールソフト","フォールトアボイダンス","フールプルーフ"]
フェールソフト|4台のプリンタのうち1台が故障しても残りの3台で印刷するなど、障害が発生した際に正常な部分だけを動作させ、全体に支障をきたさないようにするしくみ。|["フェールセーフ","フォールトトレラント","フォールトアボイダンス","フェールサーブ","フールプルーフ"]
フールプルーフ|誤った操作を行っても重大な事故を招かないよう設計すること。|["フェールセーフ","フォールトトレラント","フォールトアボイダンス","フェールサーブ","誤作動防止","人為ミス防止"]
クロック周波数|CPUやメモリの動作の基準となる信号を1秒間に発生させる回数で、Hz(ヘルツ)で表す。|["クロック速度","クロック頻度","動作周波数","駆動周波数","パルス周波数"]
MIPS|コンピュータの処理速度を測るために、1秒間に実行できる命令を100万回単位で表したもの。|["百万命令処理","百万命令実行","処理速度","実行速度","1秒間命令数"]
UPS|停電などのトラブル発生時にコンピュータを安全に停止させるため、電力を一定時間供給する装置。|["無停電電源","非停電電源","予備電源","緊急電源","バックアップ電源"]
RAID|信頼性や処理速度を向上させるために、複数のハードディスク装置を並列に組み合わせて一体化し、全体を1つのディスク装置のように扱う方式。|["冗長ディスクアレイ","过剰ディスクアレイ","ディスクアレイ","ディスク群","ハードディスクアレイ"]
ミラーリング|RAID1に相当し、複数のHDDに同じデータを書き込む方式。1台のハードディスクに障害が起きた場合でも、システムの稼働が可能となるため、信頼性が向上する。なお、処理速度は向しない。|["ディスクキャスト","ディスクコピー","エニキャスト","マルチディスク"]
ストライピング|RAID0に相当し複数のHDDに分散して書き込む方式。各HDDに対して、並列にアクセスを実行することで、処理速度が向上する。なお、信頼性は向上しない。|["スクレイピング","ストライパー","マルチディスク","ディスク群"]
OSI参照モデル|国際標準化機構(ISO)で制定された、ネットワークで使用する機器や、データを送受信する手順など7つの階層に定義したもの。|["OSI枠組み","OSIフレームワーク","OSIアーキテクチャ","OSI構造","OSI階層モデル"]
ハブ|LANケーブルの中継や分岐に用いられる集線装置。|["ジャンクション","接続箱","中継ボックス","配線ボックス","分岐装置"]
ルータ|ネットワーク間の接続を行う中継機器の一つで、IPアドレスをもとにデータの行き先を認識して転送し、パケットの経路選択機能などを持つ装置。|["ルーティング装置","経路装置","ゲートウェイ","中継装置","パケット転送装置"]
パケットフィルタリング|ルータが持つ機能の一つで、パケットの通過可否を判断する機能のこと。|["パケット選別","パケット選択","パケット判断","パケット遮断","アクセス制御"]
ゲートウェイ|プロトコルが異なるネットワーク間において、プロトコルを変換することでデータの送受信を可能にするための装置。|["門戸","入口","出口","接続点","中継点"]
プロトコル|ネットワークを通して、コンピュータどうしが通信を行うために決められた手順で、通信規約ともいう。|["通信ルール","伝送規約","伝送形式","転送形式","転送規約"]
TCP/IP|インターネットやイントラネットで標準的に使用され、OSなどの環境が異なるコンピュータ間でも通信を可能にする通信規約。|["インターネットプロトコル","ネットワークプロトコル","通信プロトコル","転送プロトコル","伝送プロトコル"]
HTTP|WebサーバとWebブラウザとの間で、HTML文書や関連した画像などのデータを送受信するための通信規約。|["WWW転送プロトコル","WWW伝送プロトコル","Web通信プロトコル","Web転送プロトコル","Web伝送プロトコル"]
FTP|HTMLファイルをWebサーバへアップロードするときなど、ネットワークを介してファイルを転送するための通信規約。|["ファイル送受信プロトコル","ファイル伝送プロトコル","ファイル交換プロトコル","ファイル通信プロトコル","データ転送プロトコル"]
POP|メールサーバのメールボックスに保存されたメールを、受信するために用いる通信規約。|["メール受信プロトコル","メール取得プロトコル","郵便受信プロトコル","郵便取得プロトコル","受信箱プロトコル"]
IMAP|メールサーバの電子メールを管理する通信規約。|["メール制御プロトコル","メール操作プロトコル","郵便制御プロトコル","郵便操作プロトコル","メールボックスプロトコル"]
SMTP|電子メールをユーザのコンピュータからメールサーバへ送信するときや、メールサーバ間でメールを転送するときに用いる通信規約。|["メール送信プロトコル","メール配送プロトコル","郵便送信プロトコル","郵便配送プロトコル","送信箱プロトコル"]
DHCP|コンピュータをネットワークに接続する際に、IPアドレスなどを自動的に割り当てる通信規約。|["自動アドレス割当プロトコル","自動設定プロトコル","自動IP設定プロトコル","自動アドレス設定プロトコル","自動パラメータ設定プロトコル"]
MACアドレス|ルータなどのネットワーク機器に割り当てられているハードウェア固有の番号。|["メディアアクセスコントロールアドレス","ハードウェアアドレス","物理アドレス","イーサネットアドレス","ネットワークアダプタアドレス"]
IPアドレス|TCP/IPプロトコルを用いたネットワーク上で、コンピュータを識別するための番号。|["インターネットアドレス","ネットワークアドレス","TCP/IPアドレス","位置アドレス","経路指定アドレス"]
プライベートIPアドレス|会社や家庭のLAN内部でコンピュータ機器を識別するために、ネットワークアドレス部とホストアドレス部で構成された番号。|["内部IPアドレス","ローカルIPアドレス","LANアドレス","イントラネットアドレス","ローカルネットワークアドレス"]
グローバルIPアドレス|インターネットに接続されたコンピュータを識別するため、一意となるように割り当てられた番号。|["公開IPアドレス","外部IPアドレス","WANアドレス","インターネットアドレス","グローバルネットワークアドレス"]
サブネットマスク|IPアドレスから、特定のグループを示すネットワークアドレスを取り出すための値。|["ネットマスク","ネットワークマスク","アドレスマスク","アドレス分割マスク","ブロードキャストアドレス"]
ネットワークアドレス|IPアドレスを構成する32ビットのビット列のうち、個々の組織が管理するネットワーク(サブネット)を識別するのに使われる部分。|["ネットワーク識別アドレス","ネットワーク識別部アドレス","ネットワーク区分アドレス","グループアドレス","サブネット識別アドレス"]
ホストアドレス|同一のネットワークグループ内で接続された個々のコンピュータ機器を識別するためのアドレス。|["ホスト識別アドレス","インタフェースアドレス","ノードアドレス","ステーションアドレス","装置アドレス"]
ポート番号|TCP/IPプロトコルを用いたネットワーク上で、IPアドレスに設けられている補助アドレスであり、アプリケーションの識別をするための番号。|["接続端末番号","入出力ポート番号","TCP/UDPポート番号","ソケット番号","通信エンドポイント"]
NAT|インターネットのグローバルIPアドレスとプライベートIPアドレスを1対1で結び付けて相互に変換し、LAN内のコンピュータがインターネットを利用できるようにするためのアドレス変換の技術。|["NOT","NET","DMZ","MDMI"]
DMZ|"非武装地帯"と呼ばれ、インターネットなどの外部ネットワークと内部ネットワークから隔離された区域(セグメント)のこと。|["BPM","NAT","DAP","MDMI"]
DNSサーバ|インターネット上で使用するドメイン名とIPアドレスを互いに変換するためのサーバ。|["プロキシサーバ","DHCPサーバ","WEBサーバ","FTPサーバ","SMTPサーバ","POPサーバ"]
POPサーバ|メールサーバのメールボックスから電子メールを受信するためのサーバ。|["DNSサーバ","プロキシサーバ","DHCPサーバ","WEBサーバ","FTPサーバ","SMTPサーバ"]
SMTPサーバ|インターネットにおいて、電子メールを宛先のメールボックスに転送するためのサーバ。|["DNSサーバ","POPサーバ","DHCPサーバ","WEBサーバ","FTPサーバ","DHCPサーバー","プロキシサーバ"]
DHCPサーバ|LAN内のコンピュータをネットワークに接続するときに、使用していないIPアドレスを自動的に割り当てるサーバ。|["DNSサーバ","POPサーバ","DHCPサーバ","WEBサーバ","FTPサーバ","SMTPサーバ","プロキシサーバ"]
プロキシサーバ|LAN内部のクライアントの代理としてインターネット接続を行うサーバ。|["DNSサーバ","POPサーバ","DHCPサーバ","WEBサーバ","FTPサーバ","SMTPサーバ"]
通信速度(bps)|ネットワーク上でデータを送受信するときに、1秒間に転送できるデータのビット数。|["送信速度","伝送速度","スループット","データレート","ビットレート"]
転送時間|データをインターネット上のサーバなどから送信・転送するときの所要時間。|["伝送時間","経過時間","所要時間","遅延時間","レイテンシ時間"]
伝送効率|データ通信において、実質的にデータを送ることができる回線の割合。|["性能","能率","実効速度","有効スループット","無駄の少ない送信"]
シンクライアント|クライアントサーバシステムで、クライアントには必要最小限の機能だけを持たせ、サーバでアプリケーションなどの管理を行うシステム構成で、情報漏えい対策としても注目されている。|["スリムクライアント","軽量クライアント","ダムクライアント","ディスクレスクライアント","サーバ依存型クライアント"]
NAS|TCP/IPのコンピュータネットワークに直接接続して使用するHDD(ハードディスクドライブ)のこと。|["ネットワークアタッチトストレージ","ネットワーク接続HDD","サーバレスストレージ","ダイレクトアタッチトストレージ","ファイルサーバ"]
Cookie|Webサイトの訪問日時や回数などの情報を、利用者のコンピュータに保存するしくみ。|["小型データ","Webデータ","ブラウザデータ","トラッキングデータ","サイト訪問データ"]
MIME|各国の言葉や画像、動画など、形式の異なるさまざまなデータを電子メールで扱うための規格。|["MAC","添付ファイルメール","多目的インターネットメール拡張","メディア対応電子メール","メールドキュメント型"]
VoIP|インターネットやイントラネットなどの情報通信ネットワークを使って、音声データを送受信する技術。|["音声通信","IP電話","ネットワーク電話","インターネット電話","パケット音声通信"]
共通鍵暗号方式|インターネットでデータを送受信する際に、第三者に内容が知られないようにデータを変換する場合、同一の鍵を用いて暗号化と復号を行う方法。|["共通暗号方式","一つ鍵暗号方式","秘密鍵暗号方式","同じ鍵暗号方式","簡易暗号方式"]
公開鍵暗号方式|インターネットでデータを送受信する際に、第三者に内容が知られないようにデータを変換する場合、異なる鍵を用いて暗号化と復号を行う方法。|["異なる鍵暗号方式","2つ鍵暗号方式","公開暗号方式","公表鍵暗号方式","厳重暗号方式"]
電子署名(ディジタル署名)|公開鍵暗号方式を応用して、文書の作成者が本人であることと、その文書が改ざんされていないことを確認する技術。電子商取引でよく利用される。|["ディジタルサイン","公開鍵署名","公開鍵電子署名","鍵付き署名","認証コード"]
認証局(CA)|電子商取引で利用される暗号化通信などで必要となる、ディジタル証明書を発行する機関。|["証明書発行機関","認定機関","認可機関","公証機関","ディジタル証明局"]
SSL|オンラインショッピングなど、インターネット上で個人情報などのデータを暗号化して、安全にやり取りするために広く普及している技術。ブラウザのURLを示す部分は｢https://｣で始まる。|["SSL暗号化通信","Secureプロトコル","セキュアソケットレイヤー","HTTPS通信","安全通信プロトコル"]
HTTPS|HTTPに、SSLによるデータ暗号化機能を付加した通信規約。|["安全WWW通信","暗号化HTTP","SSL Web接続","SSL Webアクセス","保護Web通信"]
ログファイル|コンピュータの利用状況やデータ通信の状況を記録したファイル。|["履歴ファイル","追跡ファイル","監視ファイル","調査ファイル","トレースファイル"]
システムログ|OSやアプリケーションソフトなど、コンピュータシステムの動作状態を記録したもの。何らかのトラブルなどの情報も記録される。|["OS記録","システム追跡記録","コンピュータ動作記録","システム履歴","システムトレース"]
アクセスログ|Webサーバにアクセスした人物が、いつ、どのコンピュータからどのサイトを閲覧したかなどを記録したもの。|["接続記録","参照記録","アクセス履歴","サイト訪問記録","サーバ接続記録"]
ブレーンストーミング|4つの原則を守りながら、新しいアイディアを引き出すことを目的に行われる話し合いの技法。|["脳内嵐","アイデア出し","知恵出し","集団発想法","思考技法"]
KJ法|問題点を明確にするために、情報収集→カード･グループ化→図解化→文章化の手順で行われるデータの整理方法。|["川喜田分析","図解化手法","カード整理法","データ関連付け法","アイデア整理法"]
決定表(デシジョンテーブル)|問題を解決するために、複数の条件とその条件に対応する行動を表形式に示した図。|["判断表","条件付きルール表","条件分岐表","処理選択表","実行選択表"]
DFD|4つの記号(1組の平行線、矢印、円、四角形)を用いて、データの流れと処理の関係を表す図。|["データ流図","データ移動図","データ遷移図","情報フロー図","業務フロー図"]
パート図(PERT）|アローダイアグラムともいい、プロジェクトの日程計画や日程管理に用いられ、相互関係にある作業を矢印でつないだ図。|["プロジェクト評価手法図","作業構造図","作業関連図","資源関連図","全体最適化図"]
クリティカルパス|パート図(PERT)において、作業の開始から終了までの所要日数が最長となる経路。この経路の一部に遅れが生じると、作業全体のスケジュールに影響する。|["重要経路","最重要経路","最低限経路","重大経路","必須経路"]
ABC分析|パレート図を使用して、各項目を重要な順に3つのグループに分けて、在庫管理などで分析する方法。|["選別管理法","重要度管理法","分類管理法","優先順位付け管理法","パレート法"]
パレート図|ABC分析のときに用いられるこどが多いグラフで、データを降順に並べた棒グラフと、その累計比率を表す折れ線グラフからなるグラフ。|["80対20の法則図","重要少数派分析図","偏在図","不平等図","分布状況図"]
Zグラフ|移動合計値(過去1年間分の売上累計)という特徴があるデータを用いて、一定期間の売上高の傾向を分析するときに用いるグラフ。|["Zスコア分析グラフ","移動範囲分析グラフ","移動量分析グラフ","偏差値グラフ","標準化グラフ"]
回帰分析|相関関係にある2つのデータ間の関係や傾向を分析して、結果を予測すること。|["関連分析","傾向分析","相関判定","因果関係分析","データ当てはめ"]
散布図|2つの項目の間の相関関係の有無などを示す図表。|["相関図","関係図","広がり図","ばらつき図","データマッピング"]
正の相関|2つの項目の間で、1つが増加すると、もう1つも増加する関係で、散布図においては、点のばらつき具合が右上がりの状態。|["正の依存","増加相関","右上がり関連","同方向関連","直線関係"]
負の相関|2つの項目の間で、1つが増加すると、もう1つが減少する関係で、散布図においては、点のばらつき具合が右下がりの状態。|["減少相関","逆相関","右下がり関連","反対方向関連","逆方向依存"]
回帰直線(近似曲線）|散布図において、ばらつきのあるデータの関係を導くために、誤差が最小になる直線。|["適合直線","相関直線","近似曲線","回帰曲線","当てはめ直線"]
線形計画法|費用を最小限に抑えて最大の利益を得るための生産計画など、複数の制約条件の中で、最大(最小)値を求める手法のこと。|["線形プログラミング","数理計画法","数理最適化","線形制約最適化","数学的最適化"]
ヒストグラム|データ範囲をいくつかの区間に分け、各区間に入るデータの数を柱状で表したグラフ。|["分布表","度数表","棒グラフ表","チャート表","度数グラフ"]
管理図|中央線と上下一対の限界線を引いて、製品などの特性値をプロットし、品質不良や製造工程の異常を検出して不良原因の除去や再発防止に役立てる。|["統計的処理管理図","分布管理図","モニタリング図","変動図","統計図"]
特性要因図|結果とそれに影響を及ぼしたと思われる原因の関係を体系的に表した図。直接的な原因と間接的な原因に分別して、真の問題点を明確にする効果がある。|["原因結果図","イシュカワ図","関係図","影響図","フィッシュボーン図"]
ファンチャート|ある時点のデータを基準に、その後のデータの変動を比率で表す折れ線グラフのこと。|["指標変化図","指標伸び図","指数化グラフ","伸び率グラフ","変動率グラフ"]
SWOT分析|自社の現状を、強み･弱み･機会･脅威の4つの要素に整理して、市場環境を分析すること。|["環境分析","状況分析","戦略分析","要因分析","課題抽出"]
PPM分析|事業管理手法の一つで、自社の製品またはサービスを、市場の成長率と市場の占有率から、金のなる木･花形･問題児･負け犬の4つの区分に分類して、事業展開を決定するための手法。|["製品投資分析","製品マトリックス分析","事業選択分析","製品戦略分析","事業方針決定"]
コンプライアンス|｢法令遵守｣といわれるが、企業が法律や条例を守るだけではなく、企業倫理や社会貢献などを含めて自発的に取り組んでいくこと。|["法規制遵守","社会規範遵守","ルール遵守","義務遵守","倫理遵守"]
セキュリティーポリシー|企業や団体などの組織における情報セキュリティに関する基本的な方針であり、アクセス権限や保護対象範囲の設定などを具体的にまとめたもの。|["安全方針","保護方針","守秘方針","機密方針","リスク回避方針"]
ERP(経営資源計画)|企業の持つ人材、資金、設備、情報など様々な経営資源を一元的に管理、有効活用し、業務の効率化を図るための経営全体の最適化を目指す手法。|["経営管理システム","業務システム","資源最適化","業務効率化","情報システム"]
CRM(顧客関係管理)|企業のすべての部門と顧客との間に信頼関係を築いて、企業と顧客の利益を共に向上することを目指す経営手法。|["顧客サポート","顧客満足","顧客忠誠心向上","顧客との信頼関係構築","顧客データ分析"]
BPR(業務プロセス再設計)|企業活動に関する売り上げなどの目標を設定して、目標達成のための業務内容、流れ、組織を分析し、最適化や再構築すること。|["業務改善","プロセス改善","業務効率化","改善活動","業務イノベーション"]
アウトソーシング|コスト削減などのために自社の業務や機能の一部または全部を、それを専門とする外部の専門業者に委託すること。|["外注","業務委託","作業移管","プロセス移管","サービス利用"]
アライアンス|複数の企業が互いに経済的なメリットを期待するために、企業が連携して協力体制を構築すること。|["協業","共同事業","連携","協定","協力関係"]
ハウジングサービス|顧客のサーバ自体を、ネットワーク環境の整った場所に設置するサービス。|["設備管理サービス","スペース貸し","収容サービス","設備貸与","データセンター"]
ホスティングサービス|情報通信ネットワークを利用して、自社のサーバを貸し出すサービス。|["サーバ管理サービス","サーバ提供","サーバ貸与","サーバ運用","データセンター"]
排他制御|データベースにおいて、あるデータを処理しているとき、他からの更新や書き込みなどを制限することによって、データの整合性を保つしくみ。|["競合排除","競合防止","同時実行防止","シリアライゼーション","デッドロック防止"]
ロック|同じデータに、複数のアクセスをする場合の整合性を取るための工夫。|["占有制御","更新制限","参照制限","変更制限","更新排他"]
共有ロック|データベースにおいて、ファイルを保持するために、ファイルを読み込むことは可能だが、レコードのデータの変更はできないこと。|["読み取りロック","参照ロック","共有参照","参照可能","変更不可"]
占有ロック|一つのレコードに対して一つの参照･変更･削除だけが取得できる。データを更新している途中で、他がデータを読み込んだり、変更できないようになる。|["書き込みロック","更新ロック","占有制御","変更可能","参照不可"]
デッドロック|排他制御を行った複数の処理が互いにロックをかけることで、相手のロック解除待ち状態が発生してしまい先に進まなくなる状態。|["相互待ち","循環待ち","資源待ち競合","処理待ち合い","オーバーロック"]
トランザクション|データベースにおいて、一連の更新処理のこと。|["処理単位","一連の処理","データ更新単位","データ操作単位","処理の集合"]
コミット|データベースにおいて、更新処理などがすべて正常に完結したという宣言。|["確定処理","反映処理","登録処理","適用処理","成功報告"]
ジャーナルファイル|データベースの更新前と更新後のデータの状態を記録したファイル。|["処理記録","トランザクションログ","更新ログ","操作ログ","トレース情報"]
チェックポイント|メモリ上のデータをディスクに書き込むタイミングのこと。障害発生の際、復旧作業に利用されることもある。|["保存タイミング","スナップショット","中間データ","復元地点","段階保存"]
ロールバック|データベースにおける更新処理の途中などで、何らかの理由で不都合があった場合、データの整合性を保つために、ジャーナルファイルを用いてトランザクション処理開始時点の状態に戻すこと。|["元に戻す","巻き戻し","状態回復","変更取消","更新前状態回復"]
ロールフォワード|データが保存されているハードディスクに障害が発生した場合、バックアップファイルとジャーナルファイルを用いて、ハードディスクの障害発生直前の状態に復元すること。|["再実行","更新再適用","差分反映","最新状態へ復元","操作再実施"]
概念設計|データベース設計の初期段階で、業務内容を分析して必要なデータや管理方法を検討する作業。|["概念図","概念図化","概念データモデル","概要設計","マスタ設計"]
論理設計|概念設計の結果をシステム化の対象範囲に限定して定義すること。実際の業務での画面や帳票を参考にして、システムで必要とするデータを洗い出す。|["詳細設計","論理データモデル","論理図","テーブル定義","データ関係定義"]
物理設計|論理設計の結果を用いて、処理内容などの観点から、ハードウェアの選択や、最適配置などの検討を行うこと。主キーやインデックスの設定、必要容量の算定も行う。|["実装設計","物理データモデル","テーブル配置","基本図","内部計画"]
非正規形|データの不整合や冗長性があり、DBMSへの負担がかかる表の構造。|["混乱"," 複雑"," 乱雑"," 混迷"," 矛盾"," 複合"]
第1正規化(正規形)|非正規形から、重複して繰り返し現れる項目を排除すること。|["第2正規化(正規形)"," 第3正規化(正規形)"," 第4正規化(正規形)"," 第1非正規化(非正規形)"," 第3非正規化(非正規形)"]
第2正規化(正規形)|第1正規化から、主キーと関連のある項目を別のテーブルに分割すること。|["第3正規化(正規形)"," 第4正規化(正規形)"," 第2非正規化(非正規形)"," 第3非正規化(非正規形)"]
第3正規化(正規形)|第2正規形から、主キーでない項目について、関連のある項目を別のテーブルに分割すること。|["第1正規化(正規形)"," 第4正規化(正規形)"," 第3非正規化(非正規形)"," 第1非正規化(非正規形)"]
E-R図|データベース設計において、データの関連性をモデル化するために、｢実体｣、｢属性｣、｢関係｣の3つの図形を用いて表す図。|["実体関連図"," エンティティリレーション図"," データモデル"," スキーマ図"," レーショナルモデル"," データフロー図"]
エンティティ|一単位として扱われるデータのまとまりや、データベースとして表現すべき対象物のこと。論理設計の段階では、表に相当する。|["オブジェクト"," サブジェクト"," 実体"," 事象"," モデル"," インスタンス"]
アトリビュート|エンティティが持つ特性、特徴などの値。|["特性"," 属性"," 特徴"," 要素"," 資質"," 個性"]
リレーションシップ|エンティティとエンティティの相互関係。|["関係"," つながり"," 連携"," 結びつき"," 交流"," シンクロ"]
整合性制約(参照整合性)|レコードの追加や削除が勝手に行われないように、データベースの参照関係の整合性に関する規則。|["統一性制約"," 規範制約"," 一貫性制約"," 調和制約"," 調整制約"," 調和性制約"]
副問合せ|ある表に対して問い合わせを行い、その結果を利用してさらに、次の問い合わせを行うときの最初の問い合わせ。|["サブクエリ"," 補助問い合わせ"," 補完問い合わせ"," 付加問い合わせ"," 補助クエリ"," 補完クエリ"]