フォーマット|初期化とも呼ばれ、ハードディスクなどの記憶媒体を利用できるようにするための作業。|["アップロード","インストール","ダウンロード"]
フルコントロール|ファイルやディレクトリなどに対して、読み書きや削除など、すべての操作が許可されたアクセス権限。|["変更","書き込み","読み取り"]
単体テスト|プログラムを検証する方法の一つで、モジュールごとに、正しく機能するか検証を行う方法。 |["システムテスト","結合テスト","回帰テスト"]
ゼロトラストセキュリティ|「何も信頼しない」ことを前提とし、守るべき情報資産へのアクセスに対して、すべて信用せず、安全性を検証することで、情報資産への脅威を防ぐ情報セキュリティの考え方。|["IPS(Intrusion Prevention System)","ペリメータセキュリティ","IDS(Intrusion Detection System)"]
ipconfig|Windowsにおける、TCP/IPネットワーク設定情報を確認するときに使用するコマンド。| ["dir","tree","chkdsk"]
テレビとブルーレイレコーダを接続するなど、高精細度の映像と音声データ、制御信号を1本のケーブル で送受信できるインタフェース規格。|["RFID","IrDA","HDMI","Bluetooth"]
テストラン|論理的な誤りがないかなどを確認するため、試験用のデータを利用してプログラムを実行すること。|["コンパイル","デバッグ","アセンブル"]
テザリング|スマートフォンなどの機器をアクセスポイントとして設定することで、他の通信機器をインターネットに接続させる機能。|["WEPキー","クライアントサーバシステム","SSID"]
ERP|企業の経営資源である、ヒト、モノ、カネや情報を一元的に管理して経営判断に活かす手法。|["BPR","CRM","DFD"] 
POPサーバ|電子メールにおいて、クライアントがメッセージを受信する際に接続するサーバ。|["SMTPサーバ","NTPサーバ","DHCPサーバ"]
刑法|正当な目的がなく、無断で他人のコンピュータにおいて実行させる目的で、コンピュータウイルスを作成または配布する行為を処罰の対象とする法律。|["製造物責任法","個人情報保護法","プロバイダ責任制限法"]
パンくずリスト|あるWebページにおいて、階層構造の上位ページからのリンクを順に並べて、ページの上部などに表示したもので、現在閲覧しているページが、どの階層に属しているかを知らせるもの。|["内部リンク","ウェブアクセシビリティ","サイトマップ"]
サブスクリプション|製品やサービスごとに代金を支払うのではなく、一定期間利用できる権利に対して代金を支払うビジネスモデル。|["モバイル決済","フィンテック","シュリンクフレーション"]
ポート番号|TCPおよびUDPの通信において、プロトコルやプログラムを識別するために指定する番号。|["シーケンス番号","MACアドレス","ヘッダー"]
アップデート|ソフトウェアの機能追加や不具合の修正などを行い、最新の状態にすること。["アップロード","アンインストール","フィルタリング"]
シェアウェア|機能や起動回数などに制限があり、その制限を解除して使用する場合は代金の支払いが必要なソフトウェア。|["サイトライセンス","フリーウェア","OSS"] 
GIF|Webページ上のアイコンやイラストなどに使われる、256色まで取り扱えるファイル形式。|["JPEG","MPEG","PDF"]
アウトソーシング|企業が自社の業務の一部を外部の専門業者に委託すること。専門業者に仕事を任せることで、自社にはない高度な知識と技術が活用できたり、自社内の人的資源の有効活用につなげたりすることができる。|["コンプライアンス","シンクライアント","アライアンス"]
負荷テスト|コンピュータシステムに大量のデータを処理させたり、アクセスを集中させたりすることで、実際の業務に耐えられるかを検証するためのテスト。|["退行テスト","機能テスト","回帰テスト"]
ゲートウェイ|主にOSI参照モデルのトランスポート層以上の階層で、異なるLANシステム相互間の接続をする場合に、プ ロトコルの変換を行う機器。|["リピータ","ブリッジ","ルータ"]
SDGs|国連サミットで加盟国の全会一致で採択された、2030年までに持続可能でよりよい世界を目指す国際目標を示す言葉として、適切なもの。|["SDK","SSD","SSL"]
RAID1|RAIDの分類において、ミラーリングにより同じデータを二つのディスクに書き込むことで信頼性を高め、片方のディスクに障害が発生した場合でも、データが失われない方式。|["RAID0","RAID2","RAID3"]
著作権法|プログラムのコード化された表現を保護する法律。なお、プログラム中のアイディアやアルゴリズムは保護の対象にならない。|["特許法","意匠法","商標法"]
インターネットバンキング|インターネットを介して残高照会、振込、振替などの銀行取引を行うサービス。|["オンラインショッピング","電子発注システム","POSシステム"] 
ONU|光回線を用いた通信において、光信号を電気信号に変換するための装置。|["CATVモデム","OCR","OMR"]
パレート図|ある基準時点の値を100%として、他の時点と基準時点の値を変動率に換算して描画した折れ線グラフ。|["ファンチャート","散布図","パート図"]
耐久性(Durability)|トランザクションがコミットされた時点でその変更が永続的なものとなり、結果が失われないことを保証する特性。 |["原子性(Atomicity)","一貫性(Consistency)","独立性(Isolation)"]
ハッシュタグ|SNSなどにおいて、投稿された記事を分類し検索を容易にするために、言葉やフレーズの先頭に「#」を付加したもの。|["サーチエンジン","ユーザID","パスワード"]
30|IPv4で192.168.1.64/27のネットワーク内に接続可能なホストの最大数。|["16","18","32"]
外部設計|入出力画面や帳票など、利用者側の視点で設計を行うシステム開発工程。|["内部設計","プログラム設計","プログラミング"]
コンストラクタ|プログラム言語Javaにおいて、インスタンス生成時に主に初期値の設定のために実行される、クラス名と同一の特別なメソッド。|["オーバーライド","オーバーロード","カプセル化"]
ブルーレイディスク|直径12cmの光ディスクであり、波長が約400nmのレーザー光を使うことで大容量のデータの書き込みを可能にした、片面1層で約25GBの記録メディア。|["CD","DVD","フラッシュメモリ"]
フリック|タッチパネル上で、指を弾くようにスライドする動作。|["クリック","ブルクリック","ピンチイン"]
個人情報保護法|個人情報の適正な取り扱いに関し、基本となる事項や個人情報を取り扱う事業者の遵守すべき義務などを 定めることにより、個人の権利や利益を保護することを目的とする法律。|["不正アクセス禁止法","サイバーセキュリティ基本法","プロバイダ責任制限法"]
桁落ち|有効桁数が定められている演算処理において、絶対値の大きい数と絶対値の小さい数の加減算の結果、絶対値の小さい数が無視される現象。|["打切り誤差","情報落ち","丸め誤差"]
BPR|業務内容や業務の流れ、組織構造などを、最終的に顧客に対する価値を生み出す一連の活動としての観点から分析し、根本的に考え直し、デザインし直すこと。|["アライアンス","ERP","CRM"]
セション層|OSI参照モデルにおいて、アプリケーションプロセス間での会話構成、同期、データ交換を管理するために必要な手段を提供する層。|["物理層","データリンク層","アプリケーション層"]
NAPT|プライベートIPアドレスが割り振られた複数の端末が、一つのグローバルIPアドレスを使ってインターネット等の接続を利用する仕組み。|["DHCP","DNS","RADIUS"]
カット＆ペースト|ディスプレイ上の、文章や図形などを元の位置から切り取り、それを他の位置に貼り付けること。|["コピー＆ペースト","Ｃｃ","Bcc"]
QRコード|四角形の３隅に位置検出用パターンを配することで360度読み取り可能にした二次元バーコード。|["ASCIIコード","JANコード","JISコード"]
イニシャルコスト|システムやソフトウェアなどを新規導入する際、購入、設置、初期設定など、利用開始までに必要となるコストの総額。|["ランニングコスト","リサイクルコスト","総保有コスト"]
SSID|無線ＬＡＮ通信で、アクセスポイントを識別するための名前。これにより複数のアクセスポイントとの混信を避ける。|["DNS","拡張子","グローバルＩＰアドレス"]
フールプルーフ|「列車の安全が確認されないので、列車を止めてしまう。」というような、安全が確保されない限り、危険の可能性がある本来の機能を実行させない、という安全第一に立った設計思考。|["フェールセーフ ウ フェールソフト エ フォールトトレラント"]
退行テスト|あるバグを修正した結果、新たなバグを引き起こしたり、顕在化していないバグを発覚させてしまったりし、システムの機能の停止やパフォーマンスの低下が発生していないかどうかを検証するテスト。|["機能テスト","性能テスト","負荷テスト"]
SEO|検索エンジンで検索した結果、目的のＷｅｂサイトを表示順の上位に表示されるように工夫する技術。|["ＢＰＲ","ＣＥＯ","ＳＥＭ"]
送信者の公開鍵|ディジタル署名において、受信者が暗号化されたハッシュ値を復号するために使用する鍵。|["受信者の秘密鍵","送信者の秘密鍵","受信者の公開鍵"]
ペネトレーションテスト|コンピュータやネットワークのセキュリティ上の脆弱性を発見するために、システムを実際に攻撃して侵入を試みるなどの方法で、安全性を検証するもの。|["システムテスト","ウォークスルー","ソフトウェアインスペクション"]
CPU|命令を解読し、演算処理や各装置の制御などを行うコンピュータの中心部分。|["演算装置","制御装置","主記憶装置"]
ラジオボタン|複数の項目から一つを選択させる機能をもつＧＵＩの部品。通常、項目の前に選択の有無を印で表し、既に選択されている項目以外の項目を選択すると、以前の選択が自動的に解除される。|["スピンボタン","チェックボックス","リストボックス"]
磁気ヘッド|磁気ディスク装置において、ディスク上のデータを直接読み書きする部分。|["セクタ","トラック","シリンダ"]
メッセージが改ざんされていない|ディジタル署名付きのメッセージをメールで受信したとき、このディジタル署名を検証することによって、確認できること。|["ウイルスに感染していない。","メッセージが漏えいしていない。","メッセージが特定の日時に再送信されていない。"]
フラグメンテーション|主記憶装置や、補助記憶装置内のデータ領域の割当てが断片化され、一つのまとまったデータが複数の場所に分割して配置されてしまう状態。|["ボトルネック","ページング","スラッシング"]
シングルサインオン|一度、認証されれば、許可されている複数のサーバやアプリケーションなどを利用できるしくみ。|["ワンタイムパスワード","スマートカード","ディジタルフォレンジックス"]
CHECK|ISMSプロセスにおいて、実施状況に対するレビューを行うことの、PDCAモデルでの段階。|["PLAN","DO","ACT"]
ＸＢＲＬ|財務情報の作成・流通・再利用を容易にするため、ＸＭＬをベースに開発されたデータ記述言語。|["ＸＳＬ","ＲＰＧ","ＨＴＭＬ５"]
IPv6|IPv4で表現できるアドレスは、単純計算で2^32個（約43億個）であるのに対し、2^128個（約3.4*1030億個）表現できるように開発されたプロトコル。|["CIDR","ICMP","SNMP"]
動的結合|オブジェクト指向プログラムにおいて、メッセージとメソッドを実行時に関連付け、インスタンスを多相的に振る舞わせる。|["静的結合","多重継承","カプセル化"]
エミュレータ|ボトムアップテストにおける、未完成の上位モジュールの代わりとなるテスト用モジュール。上位モジュールの代わりに下位モジュール内の命令を呼び出す役割をもつ。|["シミュレータ","スタブ","ドライバ"]
ジャーナルファイル|データベースに何らかの障害が発生したとき、復旧させるために用いる更新前と更新後のデータの状態を記録したファイル。|["バックアップファイル","ダンプファイル","トランザクションファイル"]
フォロワー|市場における競争上の４つの地位のうち、「模倣によるコストの削減を目指す戦略」を採るべき地位。|["リーダー","チャレンジャー","ニッチャー"]
Java|次のプログラム言語のうち、オブジェクト指向型の言語。|["アセンブラ","C言語","FORTRAN"]
OSS|ソフトウェアのソースコードを無償で公開し、誰でもそのソフトウェアの改良が行えるソフトウェア。|["OSI","フリーウェア","シェアウェア"]
スタック|後入れ先出し(LIFO)方式によりデータを格納処理しているデータ構造。|["キュー","ポインタ","配列"]
問題児|ＰＰＭ分析における４つの分類のうち、市場占有率を高めるための資金投入をするか、縮小・撤退するかの対応を必要とするもの。|["花形","金のなる木","負け犬"]