ブレーンストーミング|批判禁止、自由奔放、質より量、結合便乗(他人の意見に便乗)という4つのルールにより行われる|["アイデア出し","自由討論","意見収集","創造的発想","発想の転換","アイデア創出"]
KJ法|データをまとめるために考案した手法で、情報収集→カード化→グループ化→図解化→文章化という手順で進めてデータを整理して問題点を明確にする|["情報整理法","データ統合法","問題整理法","カード分類法","情報構造化","データ管理法"]
決定表|条件の組み合わせとそれに対する動作とを論理で表現したもの|["条件表","論理表","動作表","意思決定表","選択表","組み合わせ表"]
DFD|システム開発に用いられるデータの流れと処理の関係を表す図|["データフロー図","情報流れ図","システムフローチャート","プロセスフロー図","処理流れ図","データ処理図"]
パート図|アローダイアグラムともいい、作業スケジュールや工程管理に使われている技法のこと|["スケジュール図","工程図","作業フロー図","アクティビティ図","計画図","プロジェクト図"]
クリティカルパス|パート図において、作業の開始から終了までの所要日数が最長となる経路。|["重要経路","主要パス","最長経路","重要路線","主要ルート","計画経路"]
ABC分析|重要度や優先度の高い要素・項目を明らかにするために行われる分析手法。パレート図を使って分析する要素・項目群を大きい順に並べ、上位70%を占める要素群をA、70%～90%の要素群をB、それ以外の要素群をCとしてグルーピングすることで重点的に管理すべきグループがどれであるかを明らかにすることができる。|["優先度分析","重要度分析","項目分類","要素分析","グループ分析","管理分析"]
パレート図|ABC分析のときに用いられることが多いグラフで、データを降順に並べた棒グラフと、その累計比較を表す折れ線グラフからなるグラフ。|["降順グラフ","累積グラフ","分析グラフ","棒折れ線グラフ","データ解析図","統計グラフ"]
Ｚグラフ|一定期間における売上高の傾向を分析する時に用いるグラフ|["売上傾向図","期間分析グラフ","売上推移図","販売解析図","売上動向図","収益グラフ"]
回帰分析|相関関係にある２つのデータ間の関係や傾向を分析して、結果を予測すること。|["相関分析","データ予測","傾向分析","関係解析","予測モデル","データ解析"]
散布図|2つの項目の間の相関関係の有無などを示す図表。|["相関図","関係図","データポイント図","変数図","分布図","相関グラフ"]
回帰直線|散布図において、ばらつきのあるデータの関係を導くために、誤差が最小になる直線。|["トレンドライン","回帰ライン","予測直線","データ直線","解析ライン","回帰グラフ"]
線形計画法|費用を最小限に抑えて最大の利益を得るための生産計画など、複数の制約条件の中で、最大（最小）値を求める手法のこと。|["最適化法","費用分析法","利益最大化法","制約条件解析","計画最適化","生産管理法"]
ヒストグラム|データ範囲をいくつかの区間に分け、データの数を柱状で表したグラフのこと|["柱状グラフ","度数分布図","バーチャート","データ区間図","頻度図","分布グラフ"]
特性要因図|特性とそれに及ぼす要因の関係を体系的に表した図。フィッシュボーン図ともいう|["原因結果図","要因解析図","関係図","特性解析図","原因図","体系図"]
ファンチャート|ある時点のデータを基準に、その後のデータの変動を比率で表す折れ線グラフのこと。|["変動グラフ","比率分析図","折れ線図","動向図","比率変動図","基準データ図"]
SWOT分析|自社の現状を、強み・弱み・機会・脅威の4つの要素に整理して、市場環境を分析すること。|["環境分析","企業分析","要素分析","戦略分析","現状解析","市場評価"]
PPM分析|企業が製品の販売時に戦略的観点から経営資源の配分が最も効率的、効果的であるバランスのいい組み合わせを決定するための手法。金のなる木、花形、問題児、負け犬の4つに分けて分析を行う|["製品分析","市場分析","資源配分分析","戦略評価","製品戦略分析","市場評価"]
金のなる木|市場の成長率は低く、相対的な占有率は高い|["安定製品","収益源","成熟市場","収益商品","持続収益","利益確保"]
花形|市場の成長率・相対的な占有率がともに高い|["スター製品","成長商品","市場リーダー","トップ製品","急成長品","市場支配"]
問題児|市場の成長率は高く、想定的な占有率は低い|["高成長問題","課題商品","リスク製品","成長リスク","未成熟品","投資リスク"]
負け犬|市場の成長率・相対的な占有率ともに低い|["低成長品","低収益商品","市場退出品","衰退商品","不採算品","非効率品"]
コンプライアンス|法令遵守 企業が法律や条例を守るだけでなく、企業倫理や社会貢献などを含めて自発的に取り組んでいくこと|["法規遵守","倫理遵守","法令順守","企業倫理","法的順守","社会貢献"]
セキュリティポリシー|企業や団体などの組織における情報セキュリティに関する基本的な方針であり、アクセス権限や保護対象範囲の設定などを具体的にまとめたもの|["情報方針","安全指針","保護方針","セキュリティ方針","アクセス方針","情報管理方針"]
ERP|経理、生産、管理、販売管理、人事管理などの基幹業務でコンピュータシステムを使用して全体を管理すること|["業務統合管理","企業資源管理","経営資源管理","統合業務システム","企業全体管理","基幹業務管理"]
CRM|店舗やコールセンター、Webサイトなど、顧客と接する全ての部門(部署)から、顧客情報(購買履歴、コンタクト履歴など)をデーターベース化して管理する|["顧客管理","顧客情報管理","顧客データ管理","顧客関係管理","顧客情報システム","顧客履歴管理"]
BPR|企業活動に関するある目標（売上高、収益率など）を設定し、それを達成するために業務内容や業務の流れ、組織構造を分析し、最適化や再構築すること。|["業務再設計","プロセス再設計","業務再構築","業務最適化","業務改善","企業再設計"]
コアコンピタンス|企業活動において、競合他社にはない自社ならではの中枢·中核となる強み。|["主要能力","中核能力","企業強み","独自優位","競争力","中心力"]
ASP|インターネット上でアプリケーションソフトウェアや環境を提供するサービス提供者のこと。|["アプリケーションプロバイダ","ソフトウェアプロバイダ","インターネットサービスプロバイダ","アプリケーションサービスプロバイダ","ソフトウェア提供者","オンラインソフトウェアプロバイダ"]
SaaS|サービス提供者がインターネットを経由して、アプリケーションソフトウェアなどを提供するサービスのこと。|["クラウドソフトウェア","オンラインアプリケーション","サービス型ソフトウェア","インターネットソフトウェア","クラウドアプリ","ウェブアプリケーション"]
PaaS|インターネットを経由して、アプリケーションソフトウェアが稼働するための環境を提供するサービスのこと。|["プラットフォームサービス","オンライン環境提供","クラウドプラットフォーム","開発環境提供","サービス基盤","プラットフォームアズアサービス"]
IaaS|インターネットを経由して、ハードディスクや仮想サーバなどの機材やインフラ環境を提供するサービスのこと。|["インフラサービス","クラウドインフラ","仮想サーバ提供","クラウド基盤","インフラストラクチャサービス","仮想環境提供"]
アウトソーシング|システムの構築、運用、管理など、自社の業務や機能の1部をまたは、全部を、それを得意とする外部の専門業者に委託する|["外部委託","業務委託","外部サポート","外部協力","アウトタスク","外部管理"]
アライアンス|複数の企業が互いに経済的なメリットを期待するために、他者と連携して協力体制を構築する|["企業提携","協力関係","提携協力","ビジネスパートナー","共同事業","企業連携"]
ハウジングサービス|顧客がサーバーなどの機材を用意してサービス事業者に預けるサービス|["サーバ預かり","機材保管","データセンタサービス","ホストサービス","機器保管サービス","設備保管"]
ホスティングサービス|通信事業者やインターネットサービスプロバイダ(ISP)、ホスティングサービス専門の事業者などが行っていて、高速な回線などを備えたサーバを貸し出すサービス|["サーバレンタル","ウェブホスティング","インターネットホスティング","専用サーバ","レンタルサーバ","ネットホスティング"]
排他制御|データベースにおいて、あるデータを処理しているとき、他からの更新や書き込みなどを制限することによって、データの整合性を保つしくみ。|["データ制御","排他管理","アクセス制限","データ保護","更新制御","整合性維持"]
ロック|同じデータに、複数のアクセスをする場合の整合性を取るための工夫。|["アクセス制御","データ保護","排他管理","競合防止","整合性維持","同時アクセス防止"]
共有ロック|データベースにおいて、ファイルを保持するために、ファイルを読み込むことは可能だが、レコードのデータの変更はできないこと。|["読み取り専用ロック","シェアロック","変更禁止ロック","データ保護ロック","参照専用ロック","アクセス制御ロック"]
専有ロック|一つのレコードに対して一つの参照・変更・削除だけが取得できる。データを更新している途中で他がデータを読み込んだり、変更できないようになる。|["排他ロック","独占ロック","完全ロック","単一アクセスロック","変更保護ロック","更新専用ロック"]
デッドロック|排他制御を行った複数の処理が互いにロックをかけることで、相手のロック解除待ち状態が発生してしまい先に進まなくなる状態。|["相互待機","相殺ロック","ロック競合","進行停止","データロック競合","ロック状態"]
トランザクション|データベースにおいて、一連の更新処理のこと。|["処理単位","データ処理","更新操作","データ操作","一連の処理","データ取引"]
コミット|データベースにおいて、更新処理などがすべて正常に完結したという宣言。|["確定","処理完了","更新完了","データ確定","取引完了","データ保存"]
ジャーナルファイル|データベースの更新前と更新後のデータの状態を記録したファイル。|["ログファイル","更新履歴","データ記録","履歴ファイル","変更記録","トランザクション記録"]
チェックポイント|データベースのシステム障害を回復するために、ミスや不具合などを探し出し、修正する作業時にプログラムの実行を中断する特定の位置もしくは機能。|["復旧ポイント","中断位置","修復点","回復位置","システム中断点","エラーチェック"]
ロールバック|データベースにおける更新処理の途中などで、何らかの理由で不都合があった場合、データの整合性を保つために、ジャーナルファイルを用いてトランザクション処理開始時点の状態に戻すこと。|["戻し処理","取り消し処理","元に戻す","状態復旧","データ復元","取引キャンセル"]
ロールフォワード|データが保存されているハードディスクに障害が発生した場合、バックアップファイルとジャーナルファイルを用いて、ハードディスクの障害発生直前の状態に復元すること。|["前進復旧","状態進行","データ復旧","バックアップ回復","前方復旧","データ再構築"]
概念設計|データベース設計の初期段階で、業務内容を分析して必要なデータや管理方法を検討する作業。|["初期設計","データ分析","管理方法設計","業務分析","設計計画","データ構成"]
論理設計|概念設計の結果をシステム化の対象範囲に限定して定義すること。実際の業務での画面や記帳を参考にして、システムで必要とするデータを洗い出す。|["システム設計","データ定義","業務画面設計","データ抽出","業務システム化","設計定義"]
物理設計|論理設計の結果を用いて、処理内容などの観点から、ハードウェアの選択や最適配置などの検討を行うこと。主キーやインデックスの設定、必要容量の算定も行う。|["ハード設計","処理最適化","インデックス設定","容量計算","ハードウェア選定","実装設計"]
非正規形|データの矛盾や重複（冗長性）があり、DBMSへの負担がかかる表の構造。|["未正規化","データ矛盾","冗長性構造","負担表構造","整理前表","未整形データ"]
第１正規化（正規形）|非正規形から、重複して繰り返し表れる項目を排除すること。|["基本正規化","重複排除","データ整理","第1段階正規化","基礎正規化","重複項目削除"]
第２正規化（正規形）|第１正規形から、主キーと関連のある項目を別のテーブルに分割すること。|["部分依存排除","関連分割","データ分割","第2段階正規化","関連テーブル分割","部分依存分割"]
第３正規化（正規形）|第２正規形から、主キーでない項目について、関連のある項目を別のテーブルに分割すること。|["非キー依存排除","データ分割","関連テーブル分割","第3段階正規化","非キー項目分割","完全正規化"]
E-R図|データベース設計において、データの関連性をモデル化するために、「実体」、「属性」、「関係」の３つの図形を用いて表す図。|["エンティティ関係図","データモデル図","実体関係図","ERダイアグラム","データ関連図","属性関係図"]
エンティティ|一単位として扱われるデータのまとまりや、データベースとして表現すべき対象物のこと。論理設計の段階では、表に相当する。|["実体","データ単位","データ対象","論理表","データまとまり","データエンティティ"]
アトリビュート|エンティティが持つ特性、特徴などの値。|["属性","特性","特徴値","データ属性","エンティティ特性","属性値"]
リレーションシップ|エンティティとエンティティの相互関係。|["関係","相互関係","データ関係","関連性","エンティティ関係","関連"]
整合性制約（参照整合性）|レコードの追加や削除が勝手に行われないように、データベースの参照関係の整合性に関する規則。|["参照制約","データ整合性","関係制約","データ制約","参照規則","データ保護"]